ā	阿▲啊▲
á	啊▲
ǎ	啊▲
à	啊▲
a	啊▲
āi	哀挨埃哎唉▲
ái	捱癌
ǎi	矮藹
ài	愛曖艾▲唉▲礙隘
ān	安鞍氨庵諳
ǎn	俺
àn	按案暗黯岸
āng	骯
áng	昂
àng	盎
āo	凹熬▲
áo	熬▲遨
ǎo	襖拗▲
ào	奧澳懊傲拗▲
bā	八扒▲叭巴芭疤吧▲笆捌
bá	拔跋
bǎ	把▲靶
bà	把▲耙▲爸霸壩罷
ba	吧▲
bāi	掰
bái	白
bǎi	百伯▲柏▲擺
bài	敗拜
bān	班斑般搬頒扳
bǎn	板版舨闆
bàn	半伴拌絆扮辦瓣
bāng	邦幫
bǎng	榜膀▲綁
bàng	傍磅▲鎊膀▲謗蚌▲棒
bāo	包胞孢苞剝▲炮▲褒
báo	薄▲雹
bǎo	保堡▲寶飽
bào	報暴爆曝▲豹抱刨▲鮑
bēi	悲杯卑碑背▲
běi	北
bèi	倍焙背▲備憊被輩貝狽
bei	臂▲
bēn	奔▲
běn	本苯
bèn	笨奔▲
bēng	崩繃▲
běng	繃▲
bèng	蹦繃▲泵迸蚌▲
bī	逼
bí	鼻荸
bǐ	比秕彼筆鄙匕
bì	避弊幣蔽斃閉庇必泌▲秘▲辟壁璧臂▲碧畢婢裨蓖痹
biān	邊編鞭蝙
biǎn	扁▲匾貶
biàn	變便▲遍辯辨辮
biāo	標膘飆彪
biǎo	表錶
biē	憋鱉癟
bié	別
biè	彆
bīn	賓濱檳繽彬瀕
bìn	殯鬢
bīng	冰兵屏▲
bǐng	餅丙柄稟秉屏▲
bìng	病並併摒
bō	波玻菠播剝▲撥砵
bó	伯▲泊▲舶柏▲箔薄▲博搏膊脖勃渤駁帛
bǒ	跛簸▲
bò	薄▲柏▲簸▲
bo	蔔
bǔ	補捕哺卜堡▲
bù	布佈怖步部埠不埔▲簿
cā	擦
cāi	猜
cái	才財材裁
cǎi	采採彩綵踩睬
cài	菜蔡
cān	參▲餐
cán	慚殘蠶
cǎn	慘
càn	燦孱▲摻▲
cāng	倉蒼艙滄
cáng	藏▲
cāo	操糙
cáo	曹嘈槽
cǎo	草
cè	廁側測惻冊策
cēn	參▲
cén	岑
céng	曾▲層
cèng	蹭
chā	差▲插喳▲叉▲杈▲
chá	查▲茶察叉▲碴茬
chǎ	叉▲衩▲
chà	差▲詫岔剎▲叉▲杈▲衩▲
chāi	差▲拆
chái	柴豺
chān	攙摻▲
chán	單▲蟬禪▲嬋孱▲饞纏
chǎn	產鏟闡
chàn	顫▲懺
chāng	昌猖
cháng	長▲場▲腸常嘗償嫦徜裳▲
chǎng	場▲敞廠
chàng	唱倡暢悵
chāo	抄鈔吵▲超綽▲剿▲
cháo	朝▲潮嘲巢
chǎo	吵▲炒
chē	車▲
chě	扯
chè	徹撤澈掣
chēn	琛
chén	陳塵臣晨辰沈▲忱
chèn	趁稱▲襯
chēng	稱▲撐鐺▲
chéng	成城誠盛▲呈程丞承乘▲懲澄▲橙
chěng	逞騁
chèng	秤
chī	吃癡嗤
chí	池馳弛遲匙▲持踟
chǐ	齒耻尺呎侈豉
chì	翅赤斥叱熾
chōng	充沖忡衝▲憧
chóng	蟲重▲崇种
chǒng	寵
chòng	衝▲
chōu	抽
chóu	籌躊疇酬綢稠惆仇▲愁
chǒu	醜丑
chòu	臭▲
chū	初出
chú	除廚櫥躕鋤躇雛
chǔ	處▲礎楚儲
chù	處▲畜▲搐觸矗絀
chuāi	揣▲
chuǎi	揣▲
chuài	揣▲
chuān	穿川
chuán	船傳▲
chuǎn	喘
chuàn	串
chuāng	窗創▲瘡
chuáng	床幢▲
chuǎng	闖
chuàng	創▲
chuī	吹炊
chuí	垂捶錘陲鎚
chūn	春椿
chún	純唇淳醇
chǔn	蠢
chuō	戳
chuò	啜輟綽▲
cī	差▲疵
cí	辭詞祠慈磁瓷雌
cǐ	此
cì	次刺賜伺▲
cōng	聰蔥匆囪
cóng	從叢
còu	湊
cū	粗
cù	醋促簇卒▲猝
cuān	汆
cuán	攢▲
cuàn	篡竄
cuī	催摧崔
cuǐ	璀
cuì	翠粹悴萃脆
cūn	村
cún	存蹲▲
cùn	寸吋
cuō	搓磋撮▲
cuò	錯措挫銼
dā	答▲搭
dá	打▲達答▲瘩沓▲
dǎ	打▲
dà	大▲
dāi	呆
dǎi	歹逮▲
dài	代待帶袋戴貸怠殆黛玳大▲逮▲
dān	單▲丹擔▲耽眈
dǎn	膽撣
dàn	蛋旦但擔▲澹淡彈▲憚誕氮石▲
dāng	當▲噹襠鐺▲
dǎng	黨擋
dàng	盪蕩當▲檔宕
dāo	刀叨▲
dáo	叨▲
dǎo	導蹈禱島搗倒▲
dào	到道稻盜悼倒▲
dé	得▲德
de	的▲地▲得▲
děi	得▲
dēng	登燈蹬▲
děng	等
dèng	澄▲瞪鄧凳(櫈)蹬▲
dī	低滴嘀▲堤提▲
dí	敵笛狄迪的▲嘀▲嫡滌
dǐ	底抵邸砥詆
dì	弟第遞帝蒂締諦地▲的▲
diān	顛滇巔癲掂
diǎn	點典碘
diàn	電店惦甸殿澱墊奠靛玷佃
diāo	雕碉凋刁叼
diào	釣吊弔掉調▲
diē	爹跌
dié	碟諜蝶疊迭
dīng	丁叮釘▲盯仃
dǐng	頂鼎
dìng	定錠訂釘▲
diū	丟
dōng	東冬咚
dǒng	董懂
dòng	動洞胴凍棟
dōu	都▲兜
dǒu	斗抖蚪陡
dòu	鬥豆痘逗讀▲
dū	都▲嘟督
dú	獨讀▲瀆牘毒
dǔ	賭堵睹肚▲篤
dù	杜肚▲度▲渡鍍妒
duān	端
duǎn	短
duàn	段緞鍛斷
duī	堆
duì	對隊兌
dūn	敦墩蹲▲噸
dǔn	躉盹
dùn	頓盾遁鈍沌囤▲燉
duō	多哆
duó	奪度▲踱
duǒ	朵躲垛▲
duò	墮惰舵垛▲跺馱▲
ē	阿▲
é	鵝娥俄哦▲峨額訛
ě	噁
è	噩鱷厄扼愕顎遏餓惡▲
ê̄	欸▲
ế	欸▲
ê̌	欸▲
ề	欸▲
ēn	恩
ér	兒而
ěr	耳餌爾邇
èr	二貳
fā	發
fá	罰乏伐閥筏
fǎ	法
fà	髮
fān	番▲翻蕃藩帆
fán	凡煩繁▲礬樊
fǎn	反返
fàn	飯犯範販泛梵
fāng	方芳坊▲
fáng	房防坊▲妨肪
fǎng	訪紡彷仿
fàng	放
fēi	非菲▲啡緋蜚扉飛
féi	肥
fěi	匪菲▲斐翡誹
fèi	肺費廢沸吠痱
fēn	分▲吩紛芬氛
fén	焚墳
fěn	粉
fèn	奮分▲份忿憤糞
fēng	風楓瘋封豐蜂峰鋒烽
féng	逢縫▲馮▲
fěng	諷
fèng	鳯奉俸縫▲
fó	佛▲
fǒu	否▲
fū	夫膚敷孵麩
fú	扶芙符浮俘服▲伏袱福幅輻蝠佛▲彿拂鳧
fǔ	府俯腐斧釜甫輔脯撫
fù	付附咐赴縛婦負父副富傅賦覆腹復複阜服▲
gā	咖▲伽▲夾▲
gá	軋▲
gà	尬
gāi	該
gǎi	改
gài	蓋▲概溉丐鈣
gān	乾幹杆肝竿甘柑尷
gǎn	趕敢橄感桿稈
gàn	幹贛
gāng	岡崗▲剛鋼▲綱缸扛▲肛
gǎng	崗▲港
gàng	槓鋼▲
gāo	高篙膏▲羔糕
gǎo	稿搞鎬▲
gào	告膏▲
gē	格▲哥歌割鴿擱▲胳戈疙
gé	格▲革閣隔骼葛▲蛤▲頜▲擱▲
gě	葛▲合▲蓋▲
gè	個各
gěi	給▲
gēn	根跟
gēng	庚耕更▲羹
gěng	哽梗埂耿頸▲
gèng	更▲
gōng	工攻功公蚣弓躬供▲恭宮
gǒng	鞏拱汞
gòng	共供▲貢
gōu	溝勾▲鉤枸
gǒu	狗苟
gòu	勾▲夠購構垢
gū	孤咕姑菇估▲沽辜骨▲箍
gǔ	古股鼓穀骨▲蠱賈▲
gù	故估▲固僱顧
guā	瓜呱刮
guǎ	寡
guà	卦掛褂
guāi	乖
guǎi	拐柺
guài	怪
guān	官棺冠▲觀▲關
guǎn	管館
guàn	貫慣罐灌冠▲觀▲
guāng	光
guǎng	廣獷
guàng	逛
guī	歸規龜▲瑰皈矽閨
guǐ	鬼軌詭
guì	貴櫃桂跪劊
gǔn	滾
gùn	棍
guō	鍋渦▲郭過▲
guó	國
guǒ	果菓裹
guò	過▲
hā	哈▲
há	蝦▲蛤▲
hǎ	哈▲
hà	哈▲
hái	孩還▲骸
hǎi	海
hài	害亥駭
hān	酣憨
hán	寒含韓函涵汗▲
hǎn	喊罕
hàn	漢汗▲旱焊捍悍憾撼翰瀚
hāng	夯
háng	行▲杭航吭▲
hàng	巷▲
hāo	蒿
háo	豪嚎蠔壕毫號▲
hǎo	好▲
hào	耗浩好▲號▲鎬▲
hē	呵▲喝▲
hé	禾和▲河何荷▲合▲頜▲盒核▲劾涸
hè	賀和▲荷▲喝▲赫嚇▲褐鶴
hēi	黑嘿
hén	痕
hěn	很狠
hèn	恨
hēng	亨哼▲
héng	橫▲恆衡
hèng	橫▲
hng	哼▲
hōng	哄▲烘轟
hóng	紅虹▲洪鴻宏弘
hǒng	哄▲
hòng	閧
hóu	侯▲喉猴
hǒu	吼
hòu	侯▲候後后逅厚
hū	乎呼忽惚戲▲糊▲
hú	胡湖糊▲葫蝴瑚餬鬍狐弧壺核▲和▲
hǔ	虎琥唬
hù	戶護互滬糊▲
huā	花嘩▲
huá	華▲嘩▲划滑猾劃▲
huà	化話畫劃▲華▲樺
huái	懷淮踝槐徊
huài	壞
huai	劃▲
huān	歡
huán	還▲環桓
huǎn	緩
huàn	奐換喚煥瘓渙幻患宦
huāng	荒慌
huáng	黃磺簧皇惶蝗煌凰徨遑
huǎng	謊恍晃▲幌
huàng	晃▲
huī	灰恢詼揮輝暉徽
huí	回迴茴蛔
huǐ	毀燬悔
huì	會▲薈繪匯彙惠卉彗慧晦誨諱賄穢
hūn	昏婚葷
hún	魂渾混▲餛
hùn	混▲
huō	豁▲嚄▲
huó	和▲活
huǒ	火夥伙
huò	貨禍和▲或惑獲穫霍豁▲嚄▲
jī	几肌飢幾▲饑嘰機譏基箕稽▲雞畸奇▲積激擊唧緝圾羈躋
jí	及級汲笈極急集即疾嫉輯籍吉棘
jǐ	己紀▲幾▲擠濟▲給▲脊戟
jì	記紀▲忌既計繼寄技祭際季悸繫▲劑濟▲薺▲寂績冀覬跡妓鯽
jiā	加伽▲茄▲枷嘉家▲傢佳夾▲
jiá	夾▲頰莢
jiǎ	假▲甲鉀賈▲
jià	假▲價▲架駕嫁稼
jiān	間▲奸艱堅肩兼尖殲監▲煎箋姦緘漸▲
jiǎn	簡剪減碱檢儉撿瞼柬揀繭
jiàn	間▲澗件見建健鍵毽賤踐餞濺漸▲箭劍監▲檻▲艦鑑鑒薦
jiāng	將▲漿僵薑繮疆江姜
jiǎng	講獎槳蔣
jiàng	將▲醬匠降▲強▲虹▲
jiāo	交郊蛟膠教▲嬌驕焦蕉礁澆椒
jiáo	嚼▲
jiǎo	絞狡佼餃矯繳角▲腳▲僥▲攪剿▲
jiào	較教▲叫覺▲酵窖校▲轎醮嚼▲
jiē	皆階街接揭結▲秸節▲
jié	結▲桔▲潔節▲劫傑截捷睫竭
jiě	解▲姐
jiè	借藉介疥芥界戒誡屆解▲
jie	家▲價▲
jīn	今金斤巾筋禁▲襟津
jǐn	緊僅謹饉錦儘
jìn	近進晉浸禁▲噤勁▲盡燼
jīng	京經▲驚菁莖精睛晶鯨兢荊
jǐng	景憬警頸▲井阱
jìng	竟境鏡勁▲經▲徑痙靖靚▲競靜淨敬
jiǒng	迥窘
jiū	究糾赳揪鳩
jiǔ	九久玖灸酒韭
jiù	就舊舅救疚咎臼
jū	居据拘駒鞠狙車▲
jú	局焗跼菊橘桔▲
jǔ	舉矩咀▲沮▲
jù	聚句具俱颶巨距拒炬鉅據劇懼踞鋸沮▲
juān	捐娟鵑圈▲
juǎn	捲
juàn	卷倦圈▲絹
jué	決訣抉絕掘倔▲崛覺▲角▲爵嚼▲噱厥獗腳▲
juè	倔▲
jūn	均鈞軍君菌▲龜▲
jùn	俊峻竣駿郡濬菌▲
kā	咖▲
kǎ	卡▲
kāi	開揩
kǎi	楷慨凱
kài	愾
kān	看▲刊堪勘龕
kǎn	砍坎侃檻▲
kàn	看▲瞰嵌▲
kāng	康慷糠
káng	扛▲
kàng	亢抗炕
kǎo	考烤拷
kào	靠銬
kē	科蝌苛坷▲柯呵▲顆棵瞌磕
ké	咳殼▲
kě	可▲坷▲渴
kè	課客恪刻克剋可▲
kěn	肯啃懇墾
kēng	坑吭▲鏗
kōng	空▲
kǒng	孔恐
kòng	空▲控
kōu	摳
kǒu	口
kòu	扣叩寇蔻
kū	枯哭窟
kǔ	苦
kù	庫褲酷
kuā	誇
kuǎ	垮
kuà	跨挎胯
kuài	快筷塊會▲膾
kuān	寬
kuǎn	款
kuāng	框筐誆
kuáng	狂
kuàng	況礦曠框眶
kuī	虧窺盔
kuí	葵魁
kuǐ	傀
kuì	愧潰饋匱
kūn	昆崑坤
kǔn	捆
kùn	困睏
kuò	闊括擴廓
lā	拉▲垃啦▲喇▲
lá	拉▲剌▲喇▲
lǎ	拉▲喇▲
là	拉▲辣臘蠟剌▲落▲
la	啦▲
lái	來萊徠
lài	賴籟睞癩
lán	藍籃襤蘭瀾欄攔斕婪
lǎn	懶覽纜攬欖
làn	爛濫
láng	狼郎▲廊瑯螂榔
lǎng	朗
làng	浪郎▲
lāo	撈
láo	牢勞癆嘮▲
lǎo	老姥潦▲
lào	烙▲酪落▲絡▲嘮▲澇
lè	樂▲勒▲
le	了▲
lēi	勒▲
léi	雷擂▲鐳累▲纍▲
lěi	累▲壘儡纍▲磊蕾
lèi	類累▲淚肋擂▲
lēng	棱▲
léng	棱▲楞▲
lěng	冷
lèng	愣▲
lī	哩▲
lí	離籬漓璃罹梨犁黎釐厘狸喱
lǐ	里裏理哩▲鯉李禮
lì	利俐莉痢例麗隸厲勵荔吏力歷瀝靂曆立粒栗慄礫蒞
liǎ	倆▲
lián	連蓮漣槤廉簾鐮聯憐
liǎn	臉斂
liàn	練煉鍊鏈戀殮
liáng	良踉▲涼▲量▲糧梁樑粱
liǎng	兩倆▲
liàng	亮量▲諒晾涼▲輛靚▲踉▲
liāo	撩▲
liáo	寮遼僚潦▲療嘹繚撩▲燎▲聊寥
liǎo	了▲瞭▲燎▲
liào	料瞭▲鐐廖
liē	咧▲
liě	咧▲
liè	列冽烈裂獵劣捩
lie	咧▲
līn	拎
lín	林淋▲琳霖鄰鱗麟遴磷嶙臨
lǐn	凜檁
lìn	吝賃躪淋▲
líng	令▲伶蛉零齡鈴玲羚聆翎凌陵棱▲菱靈
lǐng	令▲領嶺
lìng	令▲另
liū	溜▲
liú	流琉硫留榴餾▲瘤劉瀏
liǔ	柳
liù	六▲陸▲溜▲餾▲碌▲
lōng	隆▲
lóng	龍嚨櫳聾朧籠▲隆▲窿
lǒng	籠▲攏隴壟
lòng	弄▲
lōu	摟▲
lóu	婁樓
lǒu	簍摟▲
lòu	漏陋露▲
lū	嚕
lú	盧爐蘆▲廬臚鱸顱
lǔ	魯虜擄鹵蘆▲
lù	路露▲賂陸▲鹿錄祿碌▲綠▲戮六▲
lǘ	驢
lǚ	旅屢履呂鋁侶褸縷
lǜ	慮濾律綠▲氯率▲
luán	孿攣巒
luǎn	卵
luàn	亂
lüè	略掠
lūn	掄▲
lún	侖輪淪倫綸崙論▲掄▲
lùn	論▲
luō	囉▲落▲
luó	羅蘿邏鑼籮囉▲螺騾
luǒ	裸
luò	洛落▲絡▲駱烙▲
luo	囉▲
mā	媽抹▲摩▲
má	麻嗎▲蟆
mǎ	馬碼螞瑪嗎▲
mà	罵
ma	嗎▲嘛
mái	埋▲
mǎi	買
mài	賣邁麥脈▲
mán	蠻瞞饅鰻埋▲
mǎn	滿
màn	曼慢漫幔蔓▲
máng	忙芒茫氓▲盲
mǎng	莽
māo	貓
máo	毛矛茅髦錨
mǎo	鉚
mào	冒帽瑁貿貌茂袤
me	麼
méi	玫枚霉梅莓沒▲煤媒眉嵋楣
měi	美鎂每
mèi	妹昧寐魅媚袂
mēn	悶▲
mén	門
mèn	悶▲懣
men	們
mēng	蒙▲
méng	蒙▲朦檬盟萌氓▲
měng	猛蜢錳蒙▲
mèng	夢孟
mī	瞇▲咪
mí	迷謎瞇▲彌瀰靡▲糜
mǐ	米弭靡▲
mì	泌▲秘▲密蜜覓冪
mián	棉綿眠
miǎn	免娩冕勉緬靦
miàn	面麵
miáo	苗描瞄
miǎo	秒渺藐
miào	廟妙繆▲
miē	咩
miè	滅蔑
mín	民泯
mǐn	敏皿閩憫
míng	明名銘鳴冥螟
mǐng	酩
mìng	命
miù	繆▲謬
mō	摸
mó	摩▲魔磨▲蘑模▲膜饃摹
mǒ	抹▲
mò	末沫抹▲茉沒▲莫漠寞墨默陌磨▲脈▲驀
móu	謀繆▲牟
mǒu	某
mú	模▲
mǔ	母姆拇畝牡
mù	墓慕暮募幕木沐目牧穆睦
nā	那▲
ná	拿
nǎ	哪▲那▲
nà	那▲娜▲納鈉吶捺
na	哪▲
nǎi	乃奶
nài	耐奈
nán	難▲男南喃
nǎn	腩
nàn	難▲
nāng	囊▲
náng	囊▲
nǎng	曩
náo	撓
nǎo	腦惱
nào	鬧
né	哪▲
nè	那▲
ne	呢
něi	哪▲餒
nèi	內那▲
nèn	嫩
néng	能
ńg	嗯▲
ňg	嗯▲
ng	嗯▲
nī	妮
ní	尼泥▲呢霓倪
nǐ	你擬
nì	泥▲昵膩逆溺匿
niān	拈蔫
nián	年黏粘▲
niǎn	捻攆碾
niàn	念唸
niáng	娘
niàng	釀
niǎo	鳥
niào	尿▲
niē	捏
niè	聶鑷孽
nín	您
níng	寧▲凝檸擰▲獰
nǐng	擰▲
nìng	寧▲濘擰▲
niú	牛
niǔ	扭紐鈕
niù	拗▲
nóng	農濃膿
nòng	弄▲
nú	奴
nǔ	努
nù	怒
nǚ	女
nuǎn	暖
nüè	虐瘧▲
nuó	挪娜▲
nuò	懦糯諾
ō	噢
ó	哦▲
ǒ	嚄▲
ò	哦▲
ōu	區▲歐毆鷗
ǒu	偶嘔藕
òu	慪
pā	啪趴
pá	爬扒▲琶杷耙▲
pà	怕帕
pāi	拍
pái	排▲徘牌
pǎi	排▲迫▲
pài	派湃
pān	番▲潘攀
pán	盤胖▲
pàn	判叛盼畔拚
pāng	乓膀▲
páng	旁磅▲螃膀▲徬龐
pàng	胖▲
pāo	拋泡▲
páo	袍咆炮▲刨▲
pǎo	跑
pào	炮▲泡▲
pēi	胚
péi	陪培賠
pèi	配佩沛
pēn	噴▲
pén	盆
pèn	噴▲
pēng	烹砰抨怦
péng	朋棚硼鵬彭膨澎蓬篷
pěng	捧
pèng	碰
pī	批披劈▲闢▲坯霹
pí	皮疲脾啤琵枇毗
pǐ	匹疋癖否▲劈▲
pì	譬闢▲僻媲屁
piān	扁▲偏篇翩片▲
pián	便▲
piàn	騙片▲
piāo	飄漂▲
piáo	瓢朴▲
piǎo	漂▲
piào	票漂▲
piē	瞥撇▲
piě	撇▲
pīn	拼
pín	貧頻蘋▲
pǐn	品
pìn	聘
pīng	乒
píng	平評坪萍蘋▲屏▲瓶馮▲憑
pō	坡頗泊▲潑朴▲
pó	婆鄱繁▲
pǒ	叵
pò	破魄迫▲珀朴▲
pōu	剖
póu	掊▲
pǒu	掊▲
pū	鋪▲撲仆
pú	葡脯蒲僕璞菩
pǔ	普譜圃浦樸埔▲
pù	鋪▲瀑曝▲堡▲
qī	期欺妻淒棲悽七柒戚慼嘁漆沏
qí	其棋旗麒歧岐祈鰭奇▲騎琦崎齊臍薺▲畦祇▲
qǐ	起杞豈乞企啟綺稽▲
qì	氣汽器棄砌契▲泣憩葺迄訖
qiā	掐
qiǎ	卡▲
qià	洽恰
qiān	千牽簽謙鉛▲籤慳遷
qián	前錢潛乾黔虔鉗
qiǎn	淺遣譴
qiàn	欠歉嵌▲縴
qiāng	槍腔將▲鏘嗆▲
qiáng	強▲牆
qiǎng	搶強▲
qiàng	蹌嗆▲
qiāo	敲悄▲蹺雀▲鍬
qiáo	喬僑橋蕎瞧憔翹▲
qiǎo	巧悄▲雀▲
qiào	翹▲峭俏竅殼▲撬
qiē	切▲
qié	茄▲伽▲
qiě	且
qiè	怯切▲竊愜鍥
qīn	親▲侵欽
qín	芹勤琴秦禽擒
qǐn	寢
qìn	沁
qīng	青清蜻輕卿氫傾
qíng	情晴擎
qǐng	請頃
qìng	慶罄親▲
qióng	穹窮瓊
qiū	秋鞦丘邱蚯龜▲
qiú	求球囚酋仇▲
qū	區▲軀驅嶇趨曲▲屈蛆
qú	渠
qǔ	取娶曲▲
qù	去趣
quān	圈▲
quán	全痊荃銓詮泉拳權
quǎn	犬
quàn	券▲勸
quē	缺
qué	瘸
què	確卻雀▲鵲
qún	群裙
rán	然燃
rǎn	染
rāng	嚷▲
ráng	瓤
rǎng	壤嚷▲攘
ràng	讓
ráo	饒
rǎo	擾
rào	繞
rě	惹
rè	熱
rén	人仁任▲
rěn	忍
rèn	任▲飪認刃韌紉
rēng	扔
réng	仍
rì	日
róng	容溶熔蓉鎔榕榮絨融茸
rǒng	冗
róu	柔揉蹂糅
ròu	肉
rú	如茹儒濡蠕
rǔ	乳汝辱
rù	入褥
ruǎn	軟
ruǐ	蕊
ruì	銳瑞睿
rùn	閏潤
ruò	若偌弱
sā	撒▲
sǎ	灑撒▲
sà	薩颯
sāi	鰓腮塞▲
sài	賽塞▲
sān	三叁
sǎn	散▲傘
sàn	散▲
sāng	桑喪▲
sǎng	嗓
sàng	喪▲
sāo	騷搔臊▲
sǎo	嫂掃▲
sào	掃▲臊▲
sè	色▲塞▲嗇瑟澀
sēn	森
sēng	僧
shā	沙莎鯊砂紗殺剎▲煞▲杉▲
shá	啥
shǎ	傻
shà	廈▲霎煞▲
shāi	篩
shǎi	色▲
shài	曬
shān	山舢衫刪柵▲珊姍扇▲煽杉▲苫▲
shǎn	閃陝摻▲
shàn	扇▲善膳繕汕訕擅贍單▲禪▲苫▲
shāng	商傷
shǎng	賞上▲晌
shàng	上▲尚
shang	裳▲
shāo	燒稍▲梢捎▲
sháo	勺芍
shǎo	少▲
shào	少▲紹哨稍▲捎▲
shē	奢賒
shé	蛇舌折▲
shě	捨
shè	社射舍攝懾設涉赦
shéi	誰▲
shēn	深身申伸紳呻參▲
shén	神甚▲
shěn	審嬸瀋沈▲
shèn	慎腎滲甚▲
shēng	升昇生牲笙甥聲
shéng	繩
shěng	省▲
shèng	勝聖盛▲乘▲剩
shī	師獅施詩屍失濕虱
shí	十什時拾食▲石▲蝕實識▲
shǐ	史駛使矢始屎
shì	是事試市柿世似▲視示士勢誓恃侍嗜噬逝釋式拭飾適室氏
shi	匙▲殖▲
shōu	收
shóu	熟▲
shǒu	手守首
shòu	受授狩獸瘦壽售
shū	書舒輸抒紓樞梳疏蔬殊叔淑倏
shú	孰熟▲塾贖秫
shǔ	數▲鼠暑署曙薯黍蜀屬▲
shù	數▲樹漱恕墅術述束豎庶
shuā	刷▲
shuǎ	耍
shuà	刷▲
shuāi	衰摔
shuǎi	甩
shuài	帥率▲蟀
shuān	拴栓
shuàn	涮
shuāng	雙霜孀
shuǎng	爽
shuí	誰▲
shuǐ	水
shuì	睡稅說▲
shǔn	吮
shùn	順舜瞬
shuō	說▲
shuò	朔爍碩數▲
sī	思司私絲斯撕廝嘶
sǐ	死
sì	四似▲伺▲飼嗣寺肆祀食▲
sōng	忪松鬆淞
sǒng	聳慫悚
sòng	送頌宋誦訟
sōu	搜艘餿
sǒu	叟
sòu	嗽
sū	酥穌蘇甦
sú	俗
sù	訴素塑溯速肅粟宿▲縮▲
suān	酸
suàn	算蒜
suī	雖尿▲
suí	隨綏隋遂▲
suǐ	髓
suì	歲碎穂遂▲隧邃祟
sūn	孫
sǔn	損筍
suō	縮▲梭唆嗦
suǒ	所鎖瑣索
tā	他她它牠塌踏▲
tǎ	塔
tà	沓▲踏▲榻拓▲蹋
tāi	台▲胎苔▲
tái	台▲枱苔▲颱抬臺
tài	太汰態泰
tān	坍貪攤灘癱
tán	談痰潭譚彈▲壇檀曇
tǎn	坦毯忐袒
tàn	探炭碳嘆
tāng	湯趟▲
táng	唐塘糖搪堂棠膛
tǎng	倘躺淌
tàng	燙趟▲
tāo	滔掏濤叨▲
táo	桃逃淘陶萄
tǎo	討
tào	套
tè	特忑
téng	騰謄疼藤
tī	梯踢剔
tí	提▲題啼蹄
tǐ	體
tì	涕剃替屜惕嚏
tiān	天添
tián	田填甜恬
tiǎn	腆舔
tiāo	挑▲佻
tiáo	條調▲笤
tiǎo	挑▲
tiào	跳眺
tiē	貼帖▲
tiě	帖▲鐵
tiè	帖▲
tīng	聽廳
tíng	亭停廷庭蜓霆
tǐng	艇挺
tōng	通▲
tóng	同▲銅桐童潼瞳彤
tǒng	統筒桶捅
tòng	同▲痛通▲
tōu	偷
tóu	頭投骰
tòu	透
tū	突凸禿
tú	途塗荼徒屠圖
tǔ	土吐▲
tù	吐▲兔
tuān	湍
tuán	團
tuī	推
tuí	頹
tuǐ	腿
tuì	退褪▲蛻
tūn	吞
tún	屯飩囤▲豚臀
tùn	褪▲
tuō	拖脫托託
tuó	陀駝鴕馱▲
tuǒ	妥橢
tuò	唾拓▲
wā	蛙哇窪挖
wá	娃
wǎ	瓦▲
wà	襪瓦▲
wa	哇
wāi	歪
wǎi	崴▲
wài	外
wān	彎灣蜿豌
wán	完玩頑丸
wǎn	晚挽宛碗婉惋
wàn	萬腕蔓▲
wāng	汪
wáng	王亡
wǎng	往枉罔網惘
wàng	忘妄望旺
wēi	危威微薇巍偎煨崴▲
wéi	韋圍違為▲維惟唯帷桅
wěi	偉葦緯委萎尾▲偽
wèi	位衛未味畏喂餵胃渭謂猬尉▲慰蔚▲魏為▲
wēn	溫瘟
wén	文蚊紋聞
wěn	穩吻紊
wèn	問
wēng	翁嗡
wèng	瓮
wō	窩蝸渦▲倭喔
wǒ	我
wò	臥握幄沃斡
wū	汙烏▲嗚誣屋巫
wú	無蕪吾梧吳蜈毋
wǔ	武鵡五伍午忤舞嫵侮捂
wù	誤務悟晤霧惡▲戊勿物鶩烏▲塢
xī	希稀唏烯熙溪蹊西嬉嘻昔惜息熄析晰蜥悉蟋錫夕汐吸膝犧曦犀
xí	習席襲媳
xǐ	喜洗▲徙禧銑▲
xì	細系係繫▲戲▲隙
xiā	蝦▲瞎呷
xiá	霞暇瑕遐俠峽狹轄匣
xià	下夏廈▲嚇▲
xiān	先鮮▲仙掀鍁纖暹
xián	閑嫺賢弦絃舷嫌咸鹹銜啣涎
xiǎn	顯險鮮▲蜆洗▲銑▲
xiàn	現限線腺羨憲獻陷餡縣
xiāng	香鄉相▲湘箱廂襄鑲
xiáng	詳祥翔降▲
xiǎng	想享響餉
xiàng	向嚮象像橡相▲項巷▲
xiāo	肖▲消銷削▲宵逍硝蕭瀟簫囂
xiáo	淆
xiǎo	小曉
xiào	笑孝哮校▲效傚嘯肖▲
xiē	些歇楔蝎
xié	鞋斜諧攜協脅挾擷邪▲叶
xiě	寫血▲
xiè	謝瀉卸械解▲蟹懈邂洩屑褻契▲
xīn	新薪心芯▲辛鋅欣馨
xìn	信芯▲釁
xīng	星惺腥猩興▲
xíng	形刑邢型行▲
xǐng	醒省▲
xìng	杏姓性幸倖興▲
xiōng	兄凶兇匈洶胸
xióng	雄熊
xiū	修羞休
xiǔ	朽宿▲
xiù	秀繡鏽嗅袖臭▲宿▲
xū	需須虛墟噓鬚吁
xú	徐
xǔ	許栩
xù	敘序緒絮續畜▲蓄恤婿旭煦酗
xuān	宣喧暄軒
xuán	旋▲漩玄懸
xuǎn	選癬
xuàn	眩炫渲絢旋▲券▲
xuē	薛削▲靴
xué	學穴
xuě	雪鱈
xuè	血▲謔
xūn	薰勳
xún	尋循旬詢峋巡
xùn	訓訊迅汛徇殉遜馴蕈
yā	呀▲鴉丫壓▲鴨押啞▲
yá	牙芽蚜崖涯衙
yǎ	啞▲雅
yà	亞軋▲訝壓▲
ya	呀▲
yān	煙咽▲胭淹醃嫣燕▲殷▲
yán	延筵蜒研妍簷嚴岩言炎顏鹽沿鉛▲閻
yǎn	奄掩眼演衍儼魘
yàn	彥諺驗艷宴焰厭雁燕▲嚥硯唁堰
yāng	央秧殃鴦
yáng	羊洋徉陽揚楊瘍
yǎng	養癢氧仰
yàng	樣漾恙
yāo	要▲腰夭妖邀約▲吆
yáo	搖遙謠窰姚堯僥▲肴
yǎo	咬杳舀
yào	要▲耀藥瘧▲鑰▲
yē	耶▲椰掖▲
yé	耶▲揶爺邪▲
yě	也野冶
yè	夜液腋掖▲頁業葉咽▲曳謁
yī	一衣依伊醫漪椅▲揖壹
yí	夷姨胰痍移宜怡遺疑儀頤彝
yǐ	以已椅▲倚蟻乙矣尾▲
yì	易蜴意億憶義議抑異益溢毅藝囈翼誼逸亦弈奕羿翌譯繹役疫肄裔詣屹艾▲食▲邑
yīn	因茵姻音陰殷▲
yín	銀齦吟淫
yǐn	引蚓飲▲隱癮殷▲
yìn	印蔭飲▲
yīng	英應▲膺鷹鶯嬰櫻鸚纓罌
yíng	營螢瑩熒縈迎蠅盈贏
yǐng	影穎
yìng	應▲硬映
yō	唷喲▲
yo	喲▲
yōng	庸傭雍擁臃
yǒng	永泳詠勇湧踴俑恿蛹
yòng	用傭
yōu	憂優悠幽
yóu	由油柚鈾郵尤魷遊游猶
yǒu	有▲友莠黝
yòu	又右佑幼誘有▲
yū	瘀淤迂
yú	余餘于於娛虞魚漁愉逾榆揄瑜覦輿愚腴隅
yǔ	雨語▲羽予與▲嶼宇禹
yù	欲慾浴裕喻愈諭癒御禦寓遇譽籲預玉育獄與▲域毓鬱芋馭郁豫尉▲蔚▲粥▲語▲
yuān	冤淵鴛
yuán	元園原源員▲圓袁猿轅援媛▲緣垣
yuǎn	遠
yuàn	院願苑怨媛▲
yuē	約▲曰
yuè	月越樂▲躍閱悅粵岳嶽鑰▲說▲
yūn	暈▲
yún	云芸紜耘雲勻員▲
yǔn	允
yùn	運暈▲孕韻熨蘊醞員▲
zā	紮▲
zá	雜砸
zāi	災栽
zǎi	載▲宰仔▲
zài	在再載▲
zán	咱
zǎn	攢▲
zàn	贊讚暫
zāng	髒贓
zàng	葬藏▲臟
zāo	糟遭
záo	鑿
zǎo	早澡藻蚤棗
zào	躁燥噪造皂灶
zé	則擇▲澤責嘖
zè	仄
zéi	賊
zěn	怎
zēng	曾▲增憎
zèng	贈綜▲
zhā	查▲渣喳▲楂扎紮▲
zhá	炸▲閘扎軋▲紮▲鍘
zhǎ	眨
zhà	乍詐炸▲榨柵▲咤
zhāi	摘齋
zhái	宅擇▲
zhǎi	窄
zhài	債寨
zhān	占沾粘▲詹瞻氈
zhǎn	展斬嶄輾盞
zhàn	佔站戰棧湛綻顫▲蘸
zhāng	張章彰漳樟蟑
zhǎng	長▲掌漲▲
zhàng	帳脹賬漲▲丈仗杖障
zhāo	招朝▲昭着▲
zháo	着▲
zhǎo	找爪▲沼
zhào	召照趙罩兆肇
zhē	遮折▲
zhé	折▲哲摺輒轍
zhě	者
zhè	這▲蔗浙
zhe	着▲
zhèi	這▲
zhēn	真貞偵禎珍針砧斟榛甄
zhěn	枕診疹縝
zhèn	震鎮陣振
zhēng	爭睜箏掙▲正▲征怔徵癥蒸
zhěng	整拯
zhèng	正▲政證症鄭諍掙▲
zhī	之芝支枝肢吱▲脂知蜘隻織汁祗
zhí	直值植殖▲職執姪侄
zhǐ	止址趾祉祇▲咫旨指紙
zhì	志誌痣智至致緻制製置治稚滯秩質擲炙幟識▲峙窒摯
zhōng	中▲忠盅衷鐘鍾終
zhǒng	種▲腫踵
zhòng	重▲種▲中▲仲眾
zhōu	周週州洲舟粥▲謅
zhóu	軸▲
zhǒu	帚肘
zhòu	皺縐晝驟紂咒宙軸▲
zhū	朱珠蛛株誅豬諸
zhú	竹燭逐朮
zhǔ	主拄煮屬▲囑矚
zhù	住注駐蛀柱註著▲貯佇助祝築鑄
zhuā	抓
zhuǎ	爪▲
zhuāi	拽▲
zhuǎi	轉▲
zhuài	拽▲
zhuān	專磚
zhuǎn	轉▲
zhuàn	轉▲傳▲賺撰饌
zhuāng	妝莊裝樁
zhuàng	壯狀撞幢▲
zhuī	追錐椎
zhuì	綴墜贅
zhūn	諄
zhǔn	准準
zhuō	桌捉拙
zhuó	著▲濁鐲啄琢▲濯擢卓茁灼酌
zī	資咨姿諮茲滋吱▲
zǐ	子仔▲籽姊紫滓
zì	自字漬
zōng	宗綜▲棕蹤
zǒng	總
zòng	縱粽
zōu	鄒
zǒu	走
zòu	奏揍
zū	租
zú	足族卒▲
zǔ	組阻祖詛
zuān	鑽▲
zuǎn	纂
zuàn	鑽▲
zuǐ	嘴咀▲
zuì	最醉罪
zūn	尊遵樽
zuō	作▲
zuó	昨琢▲
zuǒ	左佐撮▲
zuò	坐座做作▲
