*阿	ā
阿姨	āyí
挨	āi
挨	ái
矮	ǎi
*愛	ài
*愛國	àiguó
愛好	àihào
愛護	àihù
*愛情	àiqíng
*愛人	ài·ren
*安	ān
安定	āndìng
安靜	ānjìng
*安排	ānpái
*安全	ānquán
*安慰	ānwèi
安心	ānxīn
安置	ānzhì
安裝	ānzhuāng
氨	ān
氨基酸	ānjīsuān
岸	àn
*按	àn
*按照	ànzhào
*案	àn
*案件	ànjiàn
*暗	àn
暗示	ànshì
暗中	ànzhōng
凹	āo
熬	āo
熬	áo
奧祕	àomì
奧運會	Àoyùnhuì
*八	bā
巴	bā
扒	bā
拔	bá
*把	bǎ
*把握	bǎwò
*把兒	bàr
爸	bà
爸爸	bà·ba
*罷	bà
罷工	bàgōng
*白	bái
*白色	báisè
*白天	báitiān
*百	bǎi
百年	bǎinián
百姓	bǎixìng
*擺	bǎi
擺動	bǎidòng
*擺脫	bǎituō
拜	bài
敗	bài
*班	bān
*般	bān
搬	bān
搬家	bānjiā
搬運	bānyùn
頒佈	bānbù
*板	bǎn
板凳	bǎndèng
板塊	bǎnkuài
版	bǎn
*半	bàn
半島	bàndǎo
半導體	bàndǎotǐ
*半天	bàntiān
半夜	bànyè
伴	bàn
伴隨	bànsuí
伴奏	bànzòu
扮演	bànyǎn
*辦	bàn
*辦法	bànfǎ
*辦公室	bàngōngshì
*辦理	bànlǐ
*辦事	bànshì
瓣	bàn
*幫	bāng
幫忙	bāngmáng
*幫助	bāngzhù
榜樣	bǎngyàng
傍晚	bàngwǎn
*棒	bàng
*包	bāo
包袱	bāo·fu
包乾兒	bāogānr
*包含	bāohán
*包括	bāokuò
*包圍	bāowéi
包裝	bāozhuāng
孢子	bāozǐ
炮	bāo
*薄	báo
*保	bǎo
*保持	bǎochí
*保存	bǎocún
保管	bǎoguǎn
*保護	bǎohù
*保留	bǎoliú
保守	bǎoshŏu
*保衛	bǎowèi
保險	bǎoxiǎn
*保障	bǎozhàng
*保證	bǎozhèng
飽	bǎo
*飽和	bǎohé
寶	bǎo
寶貝	bǎobèi
寶貴	bǎoguì
寶石	bǎoshí
*抱	bào
*報	bào
*報酬	bào·chóu
*報道	bàodào
報復	bào·fù
*報告	bàogào
*報刊	bàokān
報名	bàomíng
*報紙	bàozhǐ
暴動	bàodòng
暴力	bàolì
*暴露	bàolù
暴雨	bàoyŭ
*爆發	bàofā
*爆炸	bàozhà
*杯	bēi
*背	bēi
悲哀	bēi'āi
悲慘	bēicǎn
*悲劇	bēijù
*北	běi
*北方	běifāng
貝	bèi
*背	bèi
*背後	bèihòu
*背景	bèijǐng
*倍	bèi
*被	bèi
被動	bèidòng
被告	bèigào
被子	bèi·zi
備	bèi
輩	bèi
奔	bēn
奔跑	bēnpǎo
*本	běn
本地	běndì
*本來	běnlái
*本領	běnlǐng
本能	běnnéng
*本人	běnrén
*本身	běnshēn
本事	běnshì
本事	běn·shi
本體	běntǐ
本性	běnxìng
*本質	běnzhì
苯	běn
奔	bèn
笨	bèn
崩潰	bēngkuì
蹦	bèng
逼	bī
鼻	bí
鼻孔	bíkŏng
*鼻子	bí·zi
*比	bǐ
*比較	bǐjiào
*比例	bǐlì
*比如	bǐrú
*比賽	bǐsài
比喻	bǐyù
*比重	bǐzhòng
彼	bǐ
*彼此	bǐcǐ
*筆	bǐ
筆記	bǐjì
筆者	bǐzhě
*必	bì
必定	bìdìng
*必然	bìrán
*必須	bìxū
必需	bìxū
*必要	bìyào
*畢竟	bìjìng
*畢業	bìyè
閉	bì
閉合	bìhé
*壁	bì
壁畫	bìhuà
避	bì
*避免	bìmiǎn
臂	bì
*編	biān
編輯	biānjí
編寫	biānxiě
*編制	biānzhì
*邊	biān
邊疆	biānjiāng
邊界	biānjiè
邊境	biānjìng
邊區	biānqū
邊緣	biānyuán
鞭	biān
鞭子	biān·zi
扁	biǎn
*便	biàn
便利	biànlì
*便於	biànyú
*遍	biàn
辨	biàn
辨別	biànbié
辨認	biànrèn
辯護	biànhù
*辯證	biànzhèng
*變	biàn
*變動	biàndòng
變法	biànfǎ
*變革	biàngé
變更	biàngēng
*變化	biànhuà
變換	biànhuàn
變遷	biànqiān
變態	biàntài
變形	biànxíng
變異	biànyì
標	biāo
標本	biāoběn
標題	biāotí
標語	biāoyŭ
*標誌	biāozhì
*標準	biāozhŭn
標準化	biāozhŭnhuà
*表	biǎo
表層	biǎocéng
*表達	biǎodá
*表面	biǎomiàn
*表明	biǎomíng
表皮	biǎopí
*表情	biǎoqíng
*表示	biǎoshì
表述	biǎoshù
*表現	biǎoxiàn
*表演	biǎoyǎn
表揚	biǎoyáng
表彰	biǎozhāng
*別	bié
*別人	bié·rén
賓	bīn
*冰	bīng
冰川	bīngchuān
*兵	bīng
兵力	bīnglì
丙	bǐng
柄	bǐng
屏	bǐng
餅	bǐng
*並	bìng
*並且	bìngqiě
並用	bìngyòng
*病	bìng
病變	bìngbiàn
病毒	bìngdú
病理	bìnglǐ
病情	bìngqíng
*病人	bìngrén
*波	bō
*波長	bōcháng
*波動	bōdòng
波浪	bōlàng
*玻璃	bō·lí
剝奪	bōduó
*剝削	bōxuē
撥	bō
播種	bōzhŏng
播種	bōzhòng
伯	bó
*脖子	bó·zi
*博士	bóshì
搏鬥	bódòu
*薄	bó
薄弱	bóruò
*薄	bò
捕	bŭ
捕撈	bŭlāo
捕食	bŭshí
捕捉	bŭzhuō
*補	bŭ
補償	bŭcháng
*補充	bŭchōng
補貼	bŭtiē
*不	bù
*不安	bùān
*不必	bùbì
不便	bùbiàn
不曾	bùcéng
*不錯	bùcuò
*不但	bùdàn
不當	bùdàng
不等	bùděng
不定	bùdìng
*不斷	bùduàn
*不對	bùduì
不妨	bùfáng
不服	bùfú
*不夠	bùgòu
*不顧	bùgù
*不管	bùguǎn
不光	bùguāng
*不過	bùguò
不合	bùhé
不及	bùjí
*不禁	bùjīn
*不僅	bùjǐn
*不久	bùjiŭ
不堪	bùkān
*不可	bùkě
不快	bùkuài
*不利	bùlì
*不良	bùliáng
不料	bùliào
*不論	bùlùn
*不滿	bùmǎn
不免	bùmiǎn
*不怕	bùpà
不平	bùpíng
*不然	bùrán
不容	bùróng
*不如	bùrú
不時	bùshí
不惜	bùxī
*不想	bùxiǎng
*不行	bùxíng
*不幸	bùxìng
*不許	bùxŭ
*不要	bùyào
不宜	bùyí
不已	bùyǐ
*不用	bùyòng
不止	bùzhǐ
*不足	bùzú
*步	bù
步伐	bùfá
*步驟	bùzhòu
*佈	bù
佈局	bùjú
*佈置	bùzhì
*部	bù
*部隊	bùduì
*部分	bù·fen
*部落	bùluò
*部門	bùmén
部署	bùshŭ
*部位	bùwèi
*擦	cā
猜	cāi
*才	cái
*才能	cáinéng
材	cái
*材料	cáiliào
財	cái
*財產	cáichǎn
*財富	cáifù
財力	cáilì
財務	cáiwù
*財政	cáizhèng
*纔	cái
彩	cǎi
彩色	cǎisè
*採	cǎi
*採訪	cǎifǎng
採購	cǎigòu
採集	cǎijí
*採取	cǎiqŭ
*採用	cǎiyòng
踩	cǎi
*菜	cài
蔡	cài
參	cān
*參觀	cānguān
*參加	cānjiā
*參考	cānkǎo
*參與	cānyù
參照	cānzhào
殘	cán
殘酷	cánkù
殘餘	cányú
蠶	cán
燦爛	cànlàn
倉	cāng
倉庫	cāngkù
蒼白	cāngbái
蒼蠅	cāng·ying
艙	cāng
*藏	cáng
操	cāo
操縱	cāozòng
*操作	cāozuò
曹	cáo
槽	cáo
*草	cǎo
草案	cǎo'àn
草地	cǎodì
*草原	cǎoyuán
冊	cè
*側	cè
側面	cèmiàn
側重	cèzhòng
*測	cè
*測定	cèdìng
*測量	cèliáng
測驗	cèyàn
策略	cèlüè
*曾	céng
*曾經	céngjīng
*層	céng
*層次	céngcì
叉	chā
*插	chā
*差	chā
*差別	chābié
差價	chājià
差距	chājù
*差異	chāyì
*茶	chá
茶館兒	cháguǎnr
茶葉	cháyè
*查	chá
察	chá
叉	chǎ
*差	chà
*差不多	chà·bùduō
差點兒	chàdiǎnr
*差	chāi
拆	chāi
柴	chái
纏	chán
*產	chǎn
產地	chǎndì
*產量	chǎnliàng
*產品	chǎnpǐn
*產生	chǎnshēng
*產物	chǎnwù
*產業	chǎnyè
產值	chǎnzhí
闡明	chǎnmíng
闡述	chǎnshù
顫抖	chàndŏu
*長	cháng
長城	Chángchéng
長處	cháng·chù
*長度	chángdù
長短	chángduǎn
長久	chángjiŭ
*長期	chángqī
長遠	chángyuǎn
長征	chángzhēng
*常	cháng
常規	chángguī
常年	chángnián
常識	chángshí
*場	cháng
腸	cháng
嘗	cháng
嘗試	chángshì
*場	chǎng
場地	chǎngdì
場合	chǎnghé
*場面	chǎngmiàn
*場所	chǎngsuŏ
*廠	chǎng
廠房	chǎngfáng
*唱	chàng
抄	chāo
*超	chāo
超出	chāochū
超額	chāo'é
*超過	chāoguò
超越	chāoyuè
巢	cháo
*朝	cháo
朝廷	cháotíng
潮	cháo
潮流	cháoliú
潮溼	cháoshī
吵	chǎo
炒	chǎo
*車	chē
*車間	chējiān
車輛	chēliàng
車廂	chēxiāng
車站	chēzhàn
車子	chē·zi
扯	chě
*徹底	chèdǐ
撤	chè
撤銷	chèxiāo
臣	chén
沉	chén
*沉澱	chéndiàn
沉積	chénjī
*沉默	chénmò
沉思	chénsī
*沉重	chénzhòng
沉着	chénzhuó
*陳	chén
陳舊	chénjiù
陳述	chénshù
塵	chén
趁	chèn
*稱	chèn
*稱	chēng
稱號	chēnghào
稱呼	chēng·hu
稱讚	chēngzàn
撐	chēng
*成	chéng
*成本	chéngběn
成蟲	chéngchóng
*成分	chéng·fèn
*成功	chénggōng
*成果	chéngguŏ
*成績	chéngjì
*成就	chéngjiù
*成立	chénglì
成年	chéngnián
*成人	chéngrén
*成熟	chéngshú
*成爲	chéngwéi
成效	chéngxiào
成語	chéngyŭ
*成員	chéngyuán
*成長	chéngzhǎng
*城	chéng
*城市	chéngshì
城鎮	chéngzhèn
誠	chéng
誠懇	chéngkěn
誠實	chéng·shí
*呈	chéng
*呈現	chéngxiàn
程	chéng
*程度	chéngdù
程式	chéngshì
承	chéng
承包	chéngbāo
*承擔	chéngdān
*承認	chéngrèn
承受	chéngshòu
*乘	chéng
乘機	chéngjī
乘客	chéngkè
*盛	chéng
懲罰	chéngfá
秤	chèng
*喫	chī
*喫飯	chīfàn
喫驚	chījīng
喫力	chīlì
*池	chí
池塘	chítáng
*持	chí
持久	chíjiŭ
*持續	chíxù
*遲	chí
*尺	chǐ
*尺度	chǐdù
齒	chǐ
赤	chì
赤道	chìdào
翅	chì
*翅膀	chìbǎng
充	chōng
充當	chōngdāng
*充分	chōngfèn
*充滿	chōngmǎn
充實	chōngshí
充足	chōngzú
*衝	chōng
衝動	chōngdòng
衝擊	chōngjī
衝破	chōngpò
*衝突	chōngtū
*重	chóng
*重複	chóngfù
*重新	chóngxīn
*崇拜	chóngbài
崇高	chónggāo
*蟲	chóng
*衝	chòng
*抽	chōu
*抽象	chōuxiàng
仇恨	chóuhèn
愁	chóu
醜	chŏu
臭	chòu
*出	chū
*出版	chūbǎn
出產	chūchǎn
*出發	chūfā
出發點	chūfādiǎn
出國	chūguó
*出口	chūkŏu
*出來	chū·lái
出路	chūlù
出賣	chūmài
出門	chūmén
*出去	chū·qù
出色	chūsè
出身	chūshēn
*出生	chūshēng
出售	chūshòu
出土	chūtŭ
出席	chūxí
*出現	chūxiàn
出血	chūxiě
*初	chū
*初步	chūbù
初級	chūjí
*初期	chūqī
初中	chūzhōng
*除	chú
除非	chúfēi
*除了	chú·le
廚房	chúfáng
*處	chŭ
處罰	chŭfá
處分	chŭfèn
處境	chŭjìng
*處理	chŭlǐ
*處於	chŭyú
楚	chŭ
儲備	chŭbèi
*儲存	chŭcún
儲量	chŭliàng
儲蓄	chŭxù
*畜	chù
*處	chù
觸	chù
川	chuān
*穿	chuān
*穿着	chuānzhuó
*船	chuán
船舶	chuánbó
船長	chuánzhǎng
船隻	chuánzhī
*傳	chuán
*傳播	chuánbō
傳達	chuándá
傳導	chuándǎo
傳遞	chuándì
傳教士	chuánjiàoshì
傳染病	chuánrǎnbìng
傳授	chuánshòu
*傳說	chuánshuō
*傳統	chuántŏng
喘	chuǎn
*串	chuàn
創	chuāng
創傷	chuāngshāng
窗	chuāng
窗戶	chuāng·hu
窗口	chuāngkŏu
窗子	chuāng·zi
*床	chuáng
幢	chuáng
闖	chuǎng
創	chuàng
創辦	chuàngbàn
*創立	chuànglì
創新	chuàngxīn
*創造	chuàngzào
*創造性	chuàngzàoxìng
*創作	chuàngzuò
*吹	chuī
垂	chuí
*垂直	chuízhí
錘	chuí
*春	chūn
春季	chūnjì
春節	chūnjié
春秋	chūnqiū
*春天	chūntiān
脣	chún
*純	chún
純粹	chúncuì
純潔	chúnjié
*詞	cí
詞典	cídiǎn
詞義	cíyì
詞語	cíyŭ
*磁	cí
*磁場	cíchǎng
磁力	cílì
磁鐵	cítiě
雌	cí
辭	cí
辭職	cízhí
*此	cǐ
此地	cǐdì
此後	cǐhòu
此刻	cǐkè
*此外	cǐwài
*次	cì
次數	cìshù
次序	cìxù
次要	cìyào
*刺	cì
*刺激	cìjī
賜	cì
*聰明	cōng·míng
*從	cóng
*從此	cóngcǐ
*從而	cóng'ér
*從來	cónglái
*從前	cóngqián
*從事	cóngshì
從小	cóngxiǎo
從中	cóngzhōng
叢	cóng
湊	còu
*粗	cū
粗糙	cūcāo
促	cù
促成	cùchéng
*促進	cùjìn
*促使	cùshǐ
簇	cù
竄	cuàn
催	cuī
摧殘	cuīcán
摧毀	cuīhuǐ
*村	cūn
村莊	cūnzhuāng
村子	cūn·zi
*存	cún
存款	cúnkuǎn
*存在	cúnzài
寸	cùn
挫折	cuòzhé
*措施	cuòshī
*錯	cuò
*錯誤	cuò·wù
*搭	dā
*答應	dā·ying
*打	dá
*達	dá
*達到	dádào
*答	dá
答案	dá'àn
答覆	dá·fù
*打	dǎ
打敗	dǎbài
打扮	dǎ·ban
打倒	dǎdǎo
*打擊	dǎjī
打架	dǎjià
*打開	dǎkāi
打量	dǎ·liang
*打破	dǎpò
*打算	dǎ·suan
打聽	dǎ·ting
打下	dǎxià
打仗	dǎzhàng
*大	dà
大臣	dàchén
*大膽	dàdǎn
*大地	dàdì
大豆	dàdòu
*大隊	dàduì
*大多	dàduō
*大多數	dàduōshù
大風	dàfēng
*大概	dàgài
大綱	dàgāng
大哥	dàgē
*大會	dàhuì
*大夥兒	dàhuŏr
*大家	dàjiā
大街	dàjiē
大姐	dàjiě
*大量	dàliàng
*大陸	dàlù
*大門	dàmén
*大腦	dànǎo
大炮	dàpào
*大氣	dàqì
大慶	dàqìng
*大人	dà·rén
大廈	dàshà
大嬸兒	dàshěnr
大師	dàshī
*大事	dàshì
大叔	dàshū
大體	dàtǐ
大廳	dàtīng
大王	dàwáng
*大小	dàxiǎo
*大型	dàxíng
*大學	dàxué
*大學生	dàxuéshēng
大洋	dàyáng
大衣	dàyī
大雨	dàyŭ
*大約	dàyuē
大戰	dàzhàn
*大致	dàzhì
大衆	dàzhòng
大自然	dàzìrán
*呆	dāi
*待	dāi
*大夫	dài·fu
*代	dài
*代表	dàibiǎo
代價	dàijià
代理	dàilǐ
代理人	dàilǐrén
*代替	dàitì
代謝	dàixiè
*待	dài
待遇	dàiyù
*帶	dài
帶動	dàidòng
*帶領	dàilǐng
帶頭	dàitóu
逮捕	dàibŭ
袋	dài
*貸款	dàikuǎn
*戴	dài
耽誤	dān·wu
*單	dān
*單純	dānchún
單調	dāndiào
*單獨	dāndú
*單位	dānwèi
單一	dānyī
*擔	dān
擔負	dānfù
*擔任	dānrèn
*擔心	dānxīn
膽	dǎn
*石	dàn
*但	dàn
*但是	dànshì
淡	dàn
淡水	dànshuǐ
*蛋	dàn
蛋白	dànbái
*蛋白質	dànbáizhì
*氮	dàn
*誕生	dànshēng
彈	dàn
*擔	dàn
擔子	dàn·zi
*當	dāng
當場	dāngchǎng
當初	dāngchū
*當代	dāngdài
*當地	dāngdì
當今	dāngjīn
當局	dāngjú
*當年	dāngnián
*當前	dāngqián
*當然	dāngrán
*當時	dāngshí
*當事人	dāngshìrén
當選	dāngxuǎn
當中	dāngzhōng
擋	dǎng
*黨	dǎng
*黨委	dǎngwěi
*黨員	dǎngyuán
*當	dàng
當成	dàngchéng
*當年	dàngnián
*當時	dàngshí
當天	dàngtiān
當做	dàngzuò
檔案	dàng'àn
*刀	dāo
*島	dǎo
島嶼	dǎoyŭ
*倒	dǎo
倒霉	dǎoméi
導	dǎo
導彈	dǎodàn
導管	dǎoguǎn
*導演	dǎoyǎn
*導致	dǎozhì
*到	dào
*到處	dàochù
*到達	dàodá
*到底	dàodǐ
到來	dàolái
*倒	dào
*道	dào
*道德	dàodé
道教	Dàojiào
*道理	dào·lǐ
*道路	dàolù
盜竊	dàoqiè
稻	dào
稻穀	dàogŭ
*得	dé
*得到	dédào
*得以	déyǐ
得意	déyì
*德	dé
德育	déyù
*得	dĕi
登	dēng
*登記	dēngjì
*燈	dēng
*燈光	dēngguāng
燈泡兒	dēngpàor
蹬	dēng
*等	děng
*等待	děngdài
*等到	děngdào
等候	děnghòu
*等級	děngjí
*等於	děngyú
鄧	dèng
*瞪	dèng
*低	dī
低級	dījí
低頭	dītóu
低溫	dīwēn
低下	dīxià
*滴	dī
*的確	díquè
*敵	dí
敵對	díduì
*敵人	dírén
*底	dǐ
底層	dǐcéng
*底下	dǐ·xià
抵	dǐ
抵抗	dǐkàng
抵制	dǐzhì
*地	dì
地板	dìbǎn
地表	dìbiǎo
地步	dìbù
地層	dìcéng
*地帶	dìdài
*地點	dìdiǎn
*地方	dìfāng
*地方	dì·fang
*地理	dìlǐ
*地貌	dìmào
*地面	dìmiàn
地殼	dìqiào
*地球	dìqiú
*地區	dìqū
地勢	dìshì
*地圖	dìtú
*地位	dìwèi
*地下	dìxià
*地下	dì·xia
*地形	dìxíng
地域	dìyù
地震	dìzhèn
*地質	dìzhì
*地主	dìzhŭ
地租	dìzū
*弟弟	dì·di
弟子	dìzǐ
*第	dì
帝	dì
帝國	dìguó
遞	dì
*典型	diǎnxíng
碘	diǎn
*點	diǎn
點燃	diǎnrán
*點頭	diǎntóu
*店	diàn
奠定	diàndìng
*電	diàn
電報	diànbào
電池	diànchí
電磁	diàncí
電磁波	diàncíbō
電燈	diàndēng
電動	diàndòng
*電話	diànhuà
電離	diànlí
電力	diànlì
電量	diànliàng
*電流	diànliú
*電路	diànlù
電腦	diànnǎo
電器	diànqì
*電視	diànshì
電視劇	diànshìjù
電視臺	diànshìtái
電臺	diàntái
電線	diànxiàn
*電壓	diànyā
*電影	diànyǐng
電源	diànyuán
*電子	diànzǐ
*電阻	diànzŭ
墊	diàn
澱粉	diànfěn
雕	diāo
雕刻	diāokè
雕塑	diāosù
吊	diào
*掉	diào
*調	diào
調撥	diàobō
*調查	diàochá
*調動	diàodòng
*爹	diē
跌	diē
迭	dié
*丁	dīng
盯	dīng
釘	dīng
*頂	dǐng
頂點	dǐngdiǎn
頂端	dǐngduān
*定	dìng
*定額	dìng'é
*定理	dìnglǐ
定量	dìngliàng
*定律	dìnglǜ
定期	dìngqī
定向	dìngxiàng
定型	dìngxíng
*定義	dìngyì
訂	dìng
訂貨	dìnghuò
釘	dìng
*丟	diū
*冬	dōng
*冬季	dōngjì
*冬天	dōngtiān
*東	dōng
*東北	dōngběi
*東方	dōngfāng
東南	dōngnán
東歐	Dōngōu
*東西	dōngxī
*東西	dōng·xi
*懂	dŏng
*懂得	dŏng·dé
*洞	dòng
*凍	dòng
*動	dòng
動詞	dòngcí
*動機	dòngjī
動靜	dòng·jing
*動力	dònglì
動脈	dòngmài
動能	dòngnéng
動人	dòngrén
*動手	dòngshŏu
動態	dòngtài
*動物	dòngwù
動搖	dòngyáo
*動員	dòngyuán
*動作	dòngzuò
兜	dōu
*都	dōu
*斗	dŏu
抖	dŏu
豆	dòu
豆腐	dòu·fu
逗	dòu
*鬥	dòu
*鬥爭	dòuzhēng
*都	dū
*都會	dūhuì
都市	dūshì
*毒	dú
毒素	dúsù
獨	dú
*獨立	dúlì
*獨特	dútè
獨佔	dúzhàn
獨自	dúzì
*讀	dú
*讀書	dúshū
*讀者	dúzhě
*肚子	dŭ·zi
堵	dŭ
杜	dù
肚皮	dùpí
*肚子	dù·zi
*度	dù
渡	dù
*端	duān
端正	duānzhèng
*短	duǎn
短期	duǎnqī
短暫	duǎnzàn
*段	duàn
*斷	duàn
斷定	duàndìng
*鍛鍊	duànliàn
*堆	duī
堆積	duījī
*隊	duì
*隊伍	duìwŭ
*對	duì
*對比	duìbǐ
*對不起	duì·bùqǐ
*對稱	duìchèn
*對待	duìdài
*對方	duìfāng
對付	duì·fu
對話	duìhuà
對抗	duìkàng
*對立	duìlì
對流	duìliú
對面	duìmiàn
對手	duìshŏu
*對象	duìxiàng
*對應	duìyìng
*對於	duìyú
對照	duìzhào
*噸	dūn
*蹲	dūn
*頓	dùn
*頓時	dùnshí
*多	duō
*多麼	duō·me
*多少	duō·shǎo
*多數	duōshù
多餘	duōyú
*度	duó
奪	duó
*奪取	duóqŭ
*朵	duŏ
*躲	duŏ
*阿	ē
俄	é
鵝	é
*額	é
*惡	è
惡化	èhuà
惡劣	èliè
*餓	è
恩	ēn
*而	ér
而後	érhòu
*而且	érqiě
*兒	ér
兒女	érnǚ
*兒童	értóng
*兒子	ér·zi
*耳	ěr
*耳朵	ěr·duo
爾	ěr
*二	èr
*發	fā
*發表	fābiǎo
發病	fābìng
發佈	fābù
*發出	fāchū
*發達	fādá
發電	fādiàn
*發動	fādòng
發動機	fādòngjī
發抖	fādŏu
*發揮	fāhuī
發掘	fājué
發覺	fājué
*發明	fāmíng
發起	fāqǐ
發熱	fārè
*發射	fāshè
*發生	fāshēng
*發現	fāxiàn
*發行	fāxíng
發芽	fāyá
發言	fāyán
*發揚	fāyáng
發音	fāyīn
*發育	fāyù
*發展	fāzhǎn
發作	fāzuò
罰	fá
罰款	fákuǎn
*法	fǎ
法定	fǎdìng
法官	fǎguān
*法規	fǎguī
法令	fǎlìng
*法律	fǎlǜ
法人	fǎrén
法庭	fǎtíng
法學	fǎxué
*法院	fǎyuàn
*法則	fǎzé
*法制	fǎzhì
*髮	fà
番	fān
*翻	fān
翻身	fānshēn
*翻譯	fānyì
*凡	fán
*凡是	fánshì
煩惱	fánnǎo
繁	fán
繁多	fánduō
*繁榮	fánróng
*繁殖	fánzhí
繁重	fánzhòng
*反	fǎn
*反動	fǎndòng
*反對	fǎnduì
*反而	fǎn'ér
*反覆	fǎnfù
*反抗	fǎnkàng
反面	fǎnmiàn
*反射	fǎnshè
*反映	fǎnyìng
*反應	fǎnyìng
*反正	fǎn·zhèng
*反之	fǎnzhī
返	fǎn
返回	fǎnhuí
*犯	fàn
*犯罪	fànzuì
泛	fàn
*飯	fàn
飯店	fàndiàn
範	fàn
*範疇	fànchóu
*範圍	fànwéi
*方	fāng
*方案	fāng'àn
*方便	fāngbiàn
方纔	fāngcái
*方程	fāngchéng
*方法	fāngfǎ
*方面	fāngmiàn
*方式	fāngshì
*方向	fāngxiàng
*方言	fāngyán
*方針	fāngzhēn
妨礙	fáng'ài
防	fáng
防禦	fángyù
*防止	fángzhǐ
*防治	fángzhì
*房	fáng
*房間	fángjiān
*房屋	fángwū
*房子	fáng·zi
*彷彿	fǎngfú
紡織	fǎngzhī
訪	fǎng
*訪問	fǎngwèn
*放	fàng
放大	fàngdà
*放棄	fàngqì
放射	fàngshè
放射性	fàngshèxìng
放鬆	fàngsōng
*放心	fàngxīn
*非	fēi
*非常	fēicháng
非法	fēifǎ
*飛	fēi
飛船	fēichuán
*飛機	fēijī
飛快	fēikuài
飛翔	fēixiáng
*飛行	fēixíng
飛躍	fēiyuè
*肥	féi
肥料	féiliào
匪	fěi
*肺	fèi
沸騰	fèiténg
*費	fèi
*費用	fèi·yòng
廢	fèi
廢除	fèichú
*分	fēn
分辨	fēnbiàn
*分別	fēnbié
*分佈	fēnbù
*分成	fēnchéng
分割	fēngē
*分工	fēngōng
*分化	fēnhuà
*分解	fēnjiě
*分開	fēnkāi
*分類	fēnlèi
*分離	fēnlí
*分裂	fēnliè
*分泌	fēnmì
分明	fēnmíng
*分配	fēnpèi
分歧	fēnqí
*分散	fēnsàn
*分析	fēnxī
分支	fēnzhī
*分子	fēnzǐ
*粉	fěn
粉末	fěnmò
粉碎	fěnsuì
*分	fèn
分量	fèn·liàng
*分子	fènzǐ
*份	fèn
憤怒	fènnù
*奮鬥	fèndòu
糞	fèn
*風	fēng
風暴	fēngbào
*風格	fēnggé
風光	fēngguāng
風景	fēngjǐng
風力	fēnglì
風氣	fēngqì
風俗	fēngsú
風速	fēngsù
風險	fēngxiǎn
風雨	fēngyŭ
瘋狂	fēngkuáng
*封	fēng
封閉	fēngbì
*封建	fēngjiàn
封鎖	fēngsuŏ
峰	fēng
蜂	fēng
鋒	fēng
豐	fēng
豐富	fēngfù
豐收	fēngshōu
馮	Féng
縫	féng
諷刺	fěngcì
奉	fèng
奉獻	fèngxiàn
*縫	fèng
*佛	fó
*佛教	Fójiào
否	fŏu
*否定	fŏudìng
*否認	fŏurèn
*否則	fŏuzé
*夫	fū
夫婦	fūfù
*夫妻	fūqī
*夫人	fū·rén
孵化	fūhuà
*伏	fú
伏特	fútè
*扶	fú
*服	fú
*服從	fúcóng
*服務	fúwù
服務員	fúwùyuán
*服裝	fúzhuāng
俘虜	fúlŭ
浮	fú
浮動	fúdòng
浮游	fúyóu
*符號	fúhào
*符合	fúhé
*幅	fú
幅度	fúdù
*輻射	fúshè
福	fú
福利	fúlì
府	fŭ
腐	fŭ
腐敗	fŭbài
腐蝕	fŭshí
腐朽	fŭxiŭ
輔助	fŭzhù
撫摸	fŭmō
*父母	fùmŭ
*父親	fù·qīn
付	fù
付出	fùchū
附	fù
附加	fùjiā
*附近	fùjìn
附着	fùzhuó
*服	fù
*負	fù
*負擔	fùdān
*負責	fùzé
赴	fù
*副	fù
*富	fù
*富有	fùyŏu
富裕	fùyù
婦	fù
*婦女	fùnǚ
*復	fù
復辟	fùbì
*腹	fù
複合	fùhé
*複雜	fùzá
複製	fùzhì
覆蓋	fùgài
賦	fù
賦予	fùyŭ
*該	gāi
*改	gǎi
改編	gǎibiān
*改變	gǎibiàn
*改革	gǎigé
*改進	gǎijìn
改良	gǎiliáng
*改善	gǎishàn
*改造	gǎizào
改正	gǎizhèng
改組	gǎizŭ
鈣	gài
*蓋	gài
*概括	gàikuò
概率	gàilǜ
*概念	gàiniàn
*干擾	gānrǎo
*干涉	gānshè
干預	gānyù
杆	gān
*肝	gān
肝臟	gānzàng
甘心	gānxīn
*乾	gān
乾脆	gāncuì
乾旱	gānhàn
*乾淨	gān·jìng
*乾燥	gānzào
桿	gǎn
*趕	gǎn
*趕緊	gǎnjǐn
*趕快	gǎnkuài
趕忙	gǎnmáng
*敢	gǎn
敢於	gǎnyú
*感	gǎn
*感到	gǎndào
*感動	gǎndòng
感官	gǎnguān
感激	gǎn·jī
*感覺	gǎnjué
感慨	gǎnkǎi
*感情	gǎnqíng
*感染	gǎnrǎn
*感受	gǎnshòu
感謝	gǎnxiè
感性	gǎnxìng
感應	gǎnyìng
感知	gǎnzhī
*幹	gàn
*幹部	gànbù
*剛	gāng
*剛纔	gāngcái
*綱	gāng
綱領	gānglǐng
*鋼	gāng
鋼琴	gāngqín
*鋼鐵	gāngtiě
*崗位	gǎngwèi
港	gǎng
港口	gǎngkŏu
*高	gāo
高潮	gāocháo
*高大	gāodà
高等	gāoděng
*高低	gāodī
高地	gāodì
*高度	gāodù
*高級	gāojí
高空	gāokōng
高尚	gāoshàng
高速	gāosù
*高溫	gāowēn
高校	gāoxiào
*高興	gāoxìng
高壓	gāoyā
*高原	gāoyuán
高漲	gāozhǎng
高中	gāozhōng
*搞	gǎo
稿	gǎo
告	gào
告別	gàobié
*告訴	gào·su
*哥哥	gē·ge
*歌	gē
歌唱	gēchàng
歌劇	gējù
*歌曲	gēqŭ
歌聲	gēshēng
歌頌	gēsòng
歌舞	gēwŭ
疙瘩	gē·da
胳膊	gē·bo
割	gē
鴿子	gē·zi
擱	gē
*革命	gémìng
*革新	géxīn
*格	gé
格外	géwài
*隔	gé
隔壁	gébì
隔離	gélí
*各	gè
*各自	gèzì
*個	gè
*個別	gèbié
*個人	gèrén
*個體	gètǐ
*個性	gèxìng
*給	gěi
*根	gēn
*根本	gēnběn
*根據	gēnjù
*根據地	gēnjùdì
根源	gēnyuán
*跟	gēn
跟前	gēn·qián
跟隨	gēnsuí
*更	gēng
*更新	gēngxīn
耕	gēng
*耕地	gēngdì
耕作	gēngzuò
*更	gèng
*更加	gèngjiā
*工	gōng
*工廠	gōngchǎng
*工程	gōngchéng
*工程師	gōngchéngshī
工地	gōngdì
工夫	gōng·fu
工會	gōnghuì
*工具	gōngjù
*工人	gōng·rén
工商業	gōngshāngyè
*工業	gōngyè
工業化	gōngyèhuà
*工藝	gōngyì
*工資	gōngzī
*工作	gōngzuò
弓	gōng
*公	gōng
公安	gōng'ān
公佈	gōngbù
公公	gōng·gong
*公共	gōnggòng
*公開	gōngkāi
*公理	gōnglǐ
*公路	gōnglù
*公民	gōngmín
公平	gōng·píng
公認	gōngrèn
*公社	gōngshè
*公式	gōngshì
*公司	gōngsī
公有	gōngyŏu
*公有制	gōngyŏuzhì
*公元	gōngyuán
公園	gōngyuán
公正	gōngzhèng
公主	gōngzhŭ
*功	gōng
功夫	gōng·fu
功課	gōngkè
功率	gōnglǜ
*功能	gōngnéng
攻	gōng
*攻擊	gōngjī
*供	gōng
*供給	gōngjǐ
供求	gōngqiú
*供應	gōngyìng
宮	gōng
宮廷	gōngtíng
拱	gŏng
*鞏固	gŏnggù
*共	gòng
*共產黨	Gòngchǎndǎng
共和國	gònghéguó
共鳴	gòngmíng
*共同	gòngtóng
*供	gòng
*貢獻	gòngxiàn
勾結	gōujié
鉤	gōu
*溝	gōu
溝通	gōutōng
*狗	gŏu
*夠	gòu
構	gòu
*構成	gòuchéng
構思	gòusī
*構造	gòuzào
購	gòu
*購買	gòumǎi
*估計	gūjì
*姑娘	gū·niang
孤獨	gūdú
*孤立	gūlì
*古	gŭ
*古代	gŭdài
古典	gŭdiǎn
*古老	gŭlǎo
古人	gŭrén
*股	gŭ
股票	gŭpiào
*骨	gŭ
骨幹	gŭgàn
骨骼	gŭgé
骨頭	gŭ·tou
*鼓	gŭ
鼓吹	gŭchuī
*鼓勵	gŭlì
鼓舞	gŭwŭ
*穀	gŭ
*固	gù
*固定	gùdìng
*固然	gùrán
*固體	gùtǐ
固有	gùyŏu
固執	gù·zhí
*故	gù
*故事	gù·shi
故鄉	gùxiāng
*故意	gùyì
僱	gù
顧	gù
*顧客	gùkè
顧慮	gùlǜ
顧問	gùwèn
瓜	guā
刮	guā
寡婦	guǎ·fu
*掛	guà
拐	guǎi
*怪	guài
怪物	guài·wu
*官	guān
官兵	guānbīng
官吏	guānlì
官僚	guānliáo
官員	guānyuán
冠	guān
*關	guān
關閉	guānbì
關懷	guānhuái
*關鍵	guānjiàn
關節	guānjié
關聯	guānlián
*關係	guān·xì
*關心	guānxīn
*關於	guānyú
關注	guānzhù
*觀	guān
*觀測	guāncè
*觀察	guānchá
*觀點	guāndiǎn
觀看	guānkàn
*觀念	guānniàn
*觀衆	guānzhòng
*管	guǎn
管道	guǎndào
*管理	guǎnlǐ
管轄	guǎnxiá
館	guǎn
冠	guàn
*冠軍	guànjūn
*貫徹	guànchè
貫穿	guànchuān
慣	guàn
慣性	guànxìng
灌	guàn
*灌溉	guàngài
*觀	guàn
*光	guāng
光彩	guāngcǎi
光滑	guānghuá
*光輝	guānghuī
光景	guāngjǐng
光亮	guāngliàng
光芒	guāngmáng
光明	guāngmíng
*光榮	guāngróng
*光線	guāngxiàn
光學	guāngxué
光源	guāngyuán
光澤	guāngzé
光照	guāngzhào
*廣	guǎng
*廣播	guǎngbō
廣場	guǎngchǎng
*廣大	guǎngdà
*廣泛	guǎngfàn
*廣告	guǎnggào
*廣闊	guǎngkuò
廣義	guǎngyì
逛	guàng
*規定	guīdìng
*規範	guīfàn
規格	guīgé
*規劃	guīhuà
規矩	guī·ju
*規律	guīlǜ
*規模	guīmó
*規則	guīzé
*歸	guī
歸來	guīlái
歸納	guīnà
*軌道	guǐdào
*鬼	guǐ
*鬼子	guǐ·zi
桂	guì
*貴	guì
*貴族	guìzú
跪	guì
*滾	gŭn
郭	guō
鍋	guō
*國	guó
國防	guófáng
國會	guóhuì
*國際	guójì
*國家	guójiā
*國民	guómín
國情	guóqíng
國土	guótŭ
*國王	guówáng
*國務院	guówùyuàn
*國營	guóyíng
國有	guóyŏu
*果	guŏ
果斷	guŏduàn
*果然	guŏrán
*果實	guŏshí
果樹	guŏshù
裹	guŏ
*過	guò
*過程	guòchéng
過度	guòdù
*過渡	guòdù
*過分	guòfèn
過後	guòhòu
*過來	guò·lái
過年	guònián
*過去	guòqù
*過去	guò·qù
過於	guòyú
哈	hā
*孩子	hái·zi
*還	hái
*海	hǎi
海岸	hǎi'àn
海拔	hǎibá
海帶	hǎidài
海關	hǎiguān
*海軍	hǎijūn
*海面	hǎimiàn
海區	hǎiqū
海外	hǎiwài
海灣	hǎiwān
*海洋	hǎiyáng
海域	hǎiyù
*害	hài
害蟲	hàichóng
*害怕	hàipà
*含	hán
*含量	hánliàng
含義	hányì
*寒	hán
寒冷	hánlěng
罕見	hǎnjiàn
*喊	hǎn
*汗	hàn
汗水	hànshuǐ
旱	hàn
*漢	hàn
*漢語	hànyŭ
漢子	hàn·zi
漢字	hànzì
*行	háng
行列	hángliè
*行業	hángyè
航海	hánghǎi
航空	hángkōng
航行	hángxíng
*號	háo
*好	hǎo
好比	hǎobǐ
*好處	hǎo·chù
好多	hǎoduō
好看	hǎokàn
好人	hǎorén
好事	hǎoshì
好聽	hǎotīng
*好像	hǎoxiàng
好轉	hǎozhuǎn
*好	hào
好奇	hàoqí
好事	hàoshì
耗	hào
耗費	hàofèi
*號	hào
*號召	hàozhào
*呵	hē
*喝	hē
*合	hé
合併	hébìng
*合成	héchéng
合法	héfǎ
合格	hégé
合乎	héhū
合金	héjīn
*合理	hélǐ
合力	hélì
*合適	héshì
*合同	hé·tong
*合作	hézuò
*合作社	hézuòshè
*何	hé
何必	hébì
何等	héděng
何況	hékuàng
何以	héyǐ
荷	hé
*河	hé
*河流	héliú
*和	hé
*和平	hépíng
和尚	hé·shang
*和諧	héxié
*核	hé
覈算	hésuàn
*核心	héxīn
覈	hé
盒	hé
頜	hé
*和	hè
荷	hè
*喝	hè
*黑	hēi
*黑暗	hēi'àn
黑人	hēirén
黑夜	hēiyè
痕跡	hénjì
*很	hěn
*恨	hèn
恆	héng
*恆星	héngxīng
衡量	héngliáng
*橫	héng
橫向	héngxiàng
*橫	hèng
哄	hōng
轟	hōng
洪	hóng
洪水	hóngshuǐ
*宏觀	hóngguān
宏偉	hóngwěi
*紅	hóng
*紅軍	hóngjūn
紅旗	hóngqí
*紅色	hóngsè
哄	hŏng
哄	hòng
喉嚨	hóu·lóng
猴子	hóu·zi
*厚	hòu
厚度	hòudù
*後	hòu
後邊	hòu·biān
後代	hòudài
後方	hòufāng
*後果	hòuguŏ
後悔	hòuhuǐ
*後來	hòulái
*後面	hòu·miàn
*後期	hòuqī
後人	hòurén
後世	hòushì
後天	hòutiān
候	hòu
*乎	hū
呼喊	hūhǎn
呼喚	hūhuàn
*呼吸	hūxī
呼籲	hūyù
忽略	hūlüè
*忽然	hūrán
*忽視	hūshì
弧	hú
*和	hú
*胡	hú
*湖	hú
湖泊	húpō
糊塗	hú·tu
蝴蝶	húdié
*核兒	húr
壺	hú
*虎	hŭ
*互	hù
互補	hùbŭ
*互相	hùxiāng
互助	hùzhù
*戶	hù
戶口	hùkŏu
滬	hù
護	hù
護士	hù·shi
*花	huā
花朵	huāduŏ
花費	huā·fèi
花粉	huāfěn
花色	huāsè
花生	huāshēng
花紋	huāwén
花園	huāyuán
划	huá
*華	huá
華北	huáběi
華僑	huáqiáo
滑	huá
滑動	huádòng
*化	huà
化工	huàgōng
化合	huàhé
*化合物	huàhéwù
化石	huàshí
*化學	huàxué
*話	huà
話劇	huàjù
話題	huàtí
話筒	huàtŏng
話語	huàyŭ
*華	Huà
*畫	huà
*畫家	huàjiā
*畫面	huàmiàn
劃	huà
*劃分	huàfēn
*懷	huái
懷抱	huáibào
懷念	huáiniàn
*懷疑	huáiyí
*壞	huài
壞人	huàirén
歡樂	huānlè
歡喜	huānxǐ
*歡迎	huānyíng
*還	huán
還原	huányuán
*環	huán
*環節	huánjié
*環境	huánjìng
環流	huánliú
緩	huǎn
緩和	huǎnhé
*緩慢	huǎnmàn
幻覺	huànjué
*幻想	huànxiǎng
*患	huàn
*患者	huànzhě
喚	huàn
喚起	huànqǐ
*換	huàn
荒	huāng
慌	huāng
*皇帝	huángdì
*黃	huáng
黃昏	huánghūn
*黃金	huángjīn
*黃色	huángsè
黃土	huángtŭ
晃	huǎng
晃	huàng
*灰	huī
灰塵	huīchén
灰色	huīsè
*恢復	huīfù
揮	huī
輝煌	huīhuáng
*回	huí
*回答	huídá
回顧	huígù
回歸	huíguī
*回來	huí·lái
*回去	huí·qù
*回頭	huítóu
*回憶	huíyì
迴避	huíbì
毀	huǐ
毀滅	huǐmiè
*會	huì
會場	huìchǎng
會見	huìjiàn
*會議	huìyì
會員	huìyuán
繪	huì
*繪畫	huìhuà
*彙報	huìbào
婚	hūn
婚禮	hūnlǐ
*婚姻	hūnyīn
*混	hún
渾身	húnshēn
魂	hún
*混	hùn
*混合	hùnhé
*混亂	hùnluàn
混淆	hùnxiáo
*和	huó
*活	huó
*活動	huó·dòng
*活力	huólì
*活潑	huó·po
*活躍	huóyuè
*火	huŏ
火柴	huŏchái
*火車	huŏchē
火光	huŏguāng
*火箭	huŏjiàn
火山	huŏshān
火星	huŏxīng
火焰	huŏyàn
夥伴	huŏbàn
*或	huò
或許	huòxŭ
*或者	huòzhě
*和	huò
*貨	huò
*貨幣	huòbì
貨物	huòwù
*獲	huò
*獲得	huòdé
獲取	huòqŭ
肌	jī
*肌肉	jīròu
飢餓	jī'è
*基	jī
*基本	jīběn
*基層	jīcéng
*基礎	jīchŭ
*基地	jīdì
*基督教	Jīdūjiào
基建	jījiàn
*基金	jījīn
*基因	jīyīn
基於	jīyú
*幾乎	jīhū
*機	jī
機場	jīchǎng
機車	jīchē
*機構	jīgòu
*機關	jīguān
*機會	jī·huì
*機能	jīnéng
*機器	jī·qì
機器人	jī·qìrén
機體	jītǐ
*機械	jīxiè
機械化	jīxièhuà
*機制	jīzhì
畸形	jīxíng
激	jī
*激動	jīdòng
*激發	jīfā
激勵	jīlì
*激烈	jīliè
激情	jīqíng
激素	jīsù
*積	jī
*積極	jījí
*積極性	jījíxìng
*積纍	jīlěi
積壓	jīyā
擊	jī
*雞	jī
*及	jí
*及時	jíshí
*級	jí
*即	jí
即將	jíjiāng
*即使	jíshǐ
*急	jí
急劇	jíjù
*急忙	jímáng
急性	jíxìng
急需	jíxū
急於	jíyú
*集	jí
集合	jíhé
集會	jíhuì
*集體	jítǐ
*集團	jítuán
*集中	jízhōng
集資	jízī
*極	jí
極端	jíduān
極力	jílì
*極其	jíqí
*極爲	jíwéi
*疾病	jíbìng
己	jǐ
脊	jǐ
*幾	jǐ
幾何	jǐhé
*給予	jǐyŭ
*擠	jǐ
濟濟	jǐjǐ
*技能	jìnéng
*技巧	jìqiǎo
*技術	jìshù
技術員	jìshùyuán
技藝	jìyì
季	jì
季風	jìfēng
*季節	jìjié
*既	jì
*既然	jìrán
*既是	jìshì
紀錄	jìlù
*紀律	jìlǜ
紀念	jìniàn
*記	jì
*記得	jì·dé
*記錄	jìlù
*記憶	jìyì
*記載	jìzǎi
*記者	jìzhě
*計	jì
*計劃	jìhuà
*計算	jìsuàn
寂靜	jìjìng
寂寞	jìmò
寄	jì
寄生	jìshēng
寄生蟲	jìshēngchóng
寄託	jìtuō
祭	jì
祭祀	jìsì
*劑	jì
濟	jì
繼	jì
*繼承	jìchéng
繼承人	jìchéngrén
*繼續	jìxù
*繫	jì
*加	jiā
*加工	jiāgōng
加緊	jiājǐn
加劇	jiājù
*加快	jiākuài
*加強	jiāqiáng
*加熱	jiārè
*加入	jiārù
加深	jiāshēn
*加速	jiāsù
*加以	jiāyǐ
加重	jiāzhòng
*夾	jiā
*家	jiā
家畜	jiāchù
家人	jiārén
家屬	jiāshŭ
*家庭	jiātíng
家務	jiāwù
*家鄉	jiāxiāng
*家長	jiāzhǎng
家族	jiāzú
*傢伙	jiā·huo
傢俱	jiā·jù
*夾	jiá
*甲	jiǎ
甲板	jiǎbǎn
鉀	jiǎ
*假	jiǎ
假定	jiǎdìng
*假如	jiǎrú
*假設	jiǎshè
假使	jiǎshǐ
*架	jià
架子	jià·zi
駕駛	jiàshǐ
*假	jià
嫁	jià
*價	jià
*價格	jiàgé
價錢	jià·qián
*價值	jiàzhí
*尖	jiān
*尖銳	jiānruì
肩	jiān
肩膀	jiānbǎng
*兼	jiān
*堅持	jiānchí
*堅定	jiāndìng
堅固	jiāngù
*堅決	jiānjué
堅強	jiānqiáng
堅實	jiānshí
堅硬	jiānyìng
*間	jiān
*監督	jiāndū
監視	jiānshì
監獄	jiānyù
艱巨	jiānjù
*艱苦	jiānkŭ
艱難	jiānnán
殲滅	jiānmiè
剪	jiǎn
揀	jiǎn
減	jiǎn
*減輕	jiǎnqīng
減弱	jiǎnruò
*減少	jiǎnshǎo
撿	jiǎn
檢	jiǎn
*檢查	jiǎnchá
*檢驗	jiǎnyàn
*鹼	jiǎn
繭	jiǎn
簡	jiǎn
簡稱	jiǎnchēng
*簡單	jiǎndān
簡化	jiǎnhuà
*簡直	jiǎnzhí
*件	jiàn
*見	jiàn
*見解	jiànjiě
*見面	jiànmiàn
*建	jiàn
*建國	jiànguó
*建立	jiànlì
*建設	jiànshè
*建議	jiànyì
建造	jiànzào
*建築	jiànzhù
*健康	jiànkāng
*健全	jiànquán
健壯	jiànzhuàng
*鍵	jiàn
*間	jiàn
間隔	jiàngé
*間接	jiànjiē
*漸漸	jiànjiàn
劍	jiàn
箭	jiàn
鑑別	jiànbié
*鑒定	jiàndìng
*江	jiāng
江南	jiāngnán
*將	jiāng
將近	jiāngjìn
*將軍	jiāngjūn
*將來	jiānglái
將要	jiāngyào
漿	jiāng
獎	jiǎng
獎金	jiǎngjīn
獎勵	jiǎnglì
*蔣	Jiǎng
*講	jiǎng
*講話	jiǎnghuà
講究	jiǎng·jiū
講述	jiǎngshù
降	jiàng
*降低	jiàngdī
降落	jiàngluò
降水	jiàngshuǐ
*強	jiàng
*將	jiàng
*交	jiāo
交叉	jiāochā
交錯	jiāocuò
交代	jiāodài
*交換	jiāohuàn
*交際	jiāojì
*交流	jiāoliú
交談	jiāotán
交替	jiāotì
*交通	jiāotōng
*交往	jiāowǎng
*交易	jiāoyì
交織	jiāozhī
郊區	jiāoqū
*教	jiāo
*教學	jiāoxué
焦	jiāo
焦點	jiāodiǎn
焦急	jiāojí
澆	jiāo
膠	jiāo
驕傲	jiāo'ào
嚼	jiáo
*角	jiǎo
*角度	jiǎodù
角落	jiǎoluò
*腳	jiǎo
腳步	jiǎobù
腳下	jiǎoxià
腳印	jiǎoyìn
攪	jiǎo
*叫	jiào
*叫做	jiàozuò
*校	jiào
*教	jiào
*教材	jiàocái
教導	jiàodǎo
*教會	jiàohuì
教練	jiàoliàn
*教師	jiàoshī
教室	jiàoshì
*教授	jiàoshòu
教堂	jiàotáng
*教學	jiàoxué
*教訓	jiàoxùn
教養	jiàoyǎng
教義	jiàoyì
*教育	jiàoyù
教員	jiàoyuán
*較	jiào
*較爲	jiàowéi
*覺	jiào
*皆	jiē
階層	jiēcéng
*階段	jiēduàn
*階級	jiējí
*接	jiē
*接觸	jiēchù
接待	jiēdài
*接近	jiējìn
接連	jiēlián
*接收	jiēshōu
*接受	jiēshòu
街	jiē
*街道	jiēdào
街頭	jiētóu
*揭露	jiēlù
*揭示	jiēshì
*結	jiē
*結果	jiēguŏ
結實	jiē·shi
傑出	jiéchū
*結	jié
*結構	jiégòu
*結果	jiéguŏ
*結合	jiéhé
*結婚	jiéhūn
*結晶	jiéjīng
結局	jiéjú
*結論	jiélùn
*結束	jiéshù
結算	jiésuàn
*節	jié
*節目	jiémù
*節日	jiérì
節省	jiéshěng
*節約	jiéyuē
*節奏	jiézòu
截	jié
竭力	jiélì
潔白	jiébái
*姐姐	jiě·jie
姐妹	jiěmèi
*解	jiě
解除	jiěchú
解答	jiědá
*解放	jiěfàng
解放軍	jiěfàngjūn
*解決	jiějué
解剖	jiěpōu
解散	jiěsàn
*解釋	jiěshì
解脫	jiětuō
*介紹	jièshào
戒	jiè
*屆	jiè
*界	jiè
*界限	jièxiàn
*借	jiè
借鑒	jièjiàn
借款	jièkuǎn
借用	jièyòng
借助	jièzhù
*解	jiè
藉口	jièkŏu
*今	jīn
*今後	jīnhòu
*今年	jīnnián
*今日	jīnrì
*今天	jīntiān
*斤	jīn
*金	jīn
金額	jīn'é
金牌	jīnpái
金錢	jīnqián
金融	jīnróng
*金屬	jīnshŭ
津	jīn
*僅	jǐn
謹慎	jǐnshèn
*緊	jǐn
*緊急	jǐnjí
*緊密	jǐnmì
*緊張	jǐnzhāng
錦標賽	jǐnbiāosài
*儘	jǐn
*儘管	jǐnguǎn
儘快	jǐnkuài
*儘量	jǐnliàng
*近	jìn
*近代	jìndài
近來	jìnlái
近似	jìnsì
*勁	jìn
晉	jìn
浸	jìn
*進	jìn
*進步	jìnbù
*進程	jìnchéng
進而	jìn'ér
*進攻	jìngōng
*進化	jìnhuà
進軍	jìnjūn
*進口	jìnkŏu
*進來	jìn·lái
進取	jìnqŭ
*進去	jìn·qù
*進入	jìnrù
*進行	jìnxíng
*進展	jìnzhǎn
*禁止	jìnzhǐ
*盡	jìn
盡力	jìnlì
*盡量	jìnliàng
*京	jīng
京劇	Jīngjù
鯨	jīng
*莖	jīng
*經	jīng
*經常	jīngcháng
經典	jīngdiǎn
經費	jīngfèi
*經過	jīngguò
*經濟	jīngjì
*經理	jīnglǐ
*經歷	jīnglì
經受	jīngshòu
*經驗	jīngyàn
*經營	jīngyíng
*晶	jīng
*晶體	jīngtǐ
*精	jīng
*精力	jīnglì
精密	jīngmì
*精確	jīngquè
*精神	jīngshén
*精神	jīng·shen
精細	jīngxì
精心	jīngxīn
精子	jīngzǐ
驚	jīng
驚奇	jīngqí
驚人	jīngrén
驚喜	jīngxǐ
驚醒	jīngxǐng
驚訝	jīngyà
驚異	jīngyì
井	jǐng
景	jǐng
景色	jǐngsè
景物	jǐngwù
景象	jǐngxiàng
頸	jǐng
*警察	jǐngchá
警告	jǐnggào
警惕	jǐngtì
*勁	jìng
徑	jìng
*淨	jìng
淨化	jìnghuà
*靜	jìng
靜脈	jìngmài
靜止	jìngzhǐ
*竟	jìng
竟然	jìngrán
境	jìng
境地	jìngdì
*境界	jìngjiè
*鏡	jìng
鏡頭	jìngtóu
鏡子	jìng·zi
敬	jìng
競賽	jìngsài
*競爭	jìngzhēng
究	jiū
*究竟	jiūjìng
糾紛	jiūfēn
*糾正	jiūzhèng
*九	jiŭ
*久	jiŭ
*酒	jiŭ
酒精	jiŭjīng
*救	jiù
救國	jiùguó
救濟	jiùjì
*就	jiù
*就是	jiùshì
就算	jiùsuàn
就業	jiùyè
舅舅	jiù·jiu
*舊	jiù
*車	jū
*居	jū
*居民	jūmín
*居然	jūrán
居於	jūyú
*居住	jūzhù
*局	jú
*局部	júbù
*局面	júmiàn
局勢	júshì
局限	júxiàn
菊花	júhuā
咀嚼	jŭjué
*舉	jŭ
*舉辦	jŭbàn
舉動	jŭdòng
*舉行	jŭxíng
巨	jù
*巨大	jùdà
*拒絕	jùjué
距	jù
*距離	jùlí
*句	jù
*句子	jù·zi
*具	jù
*具備	jùbèi
*具體	jùtǐ
*具有	jùyŏu
俱	jù
聚	jù
聚集	jùjí
劇	jù
*劇本	jùběn
劇場	jùchǎng
劇烈	jùliè
劇團	jùtuán
劇種	jùzhŏng
*據	jù
據點	jùdiǎn
*據說	jùshuō
捐	juān
*圈	juān
*捲	juǎn
*卷	juàn
*圈	juàn
*角	jué
*角色	juésè
*決	jué
*決策	juécè
*決定	juédìng
決定性	juédìngxìng
*決心	juéxīn
*決議	juéyì
*絕	jué
*絕對	juéduì
絕望	juéwàng
*覺	jué
*覺得	jué·dé
*覺悟	juéwù
嚼	jué
君	jūn
君主	jūnzhŭ
*均	jūn
均衡	jūnhéng
*均勻	jūnyún
*軍	jūn
*軍隊	jūnduì
*軍閥	jūnfá
軍官	jūnguān
軍艦	jūnjiàn
軍民	jūnmín
*軍人	jūnrén
*軍事	jūnshì
*菌	jūn
咖啡	kāfēi
卡	kǎ
*開	kāi
開辦	kāibàn
開採	kāicǎi
開創	kāichuàng
*開發	kāifā
*開放	kāifàng
開關	kāiguān
開花	kāihuā
*開會	kāihuì
開墾	kāikěn
*開口	kāikŏu
開闊	kāikuò
開門	kāimén
開幕	kāimù
*開闢	kāipì
開設	kāishè
*開始	kāishǐ
開水	kāishuǐ
開頭	kāitóu
開拓	kāituò
開玩笑	kāiwánxiào
*開展	kāizhǎn
開支	kāizhī
刊登	kāndēng
刊物	kānwù
*看	kān
勘探	kāntàn
砍	kǎn
*看	kàn
看待	kàndài
*看法	kàn·fǎ
*看見	kàn·jiàn
看望	kàn·wàng
扛	káng
*抗	kàng
抗議	kàngyì
*抗戰	kàngzhàn
*考	kǎo
*考察	kǎochá
考古	kǎogŭ
考覈	kǎohé
*考慮	kǎolǜ
*考試	kǎoshì
考驗	kǎoyàn
*靠	kào
靠近	kàojìn
*科	kē
*科技	kējì
*科學	kēxué
*科學家	kēxuéjiā
科學院	kēxuéyuàn
*科研	kēyán
*棵	kē
*顆	kē
顆粒	kēlì
咳	ké
咳嗽	ké·sou
殼	ké
*可	kě
*可愛	kě'ài
*可見	kějiàn
*可靠	kěkào
*可憐	kělián
*可能	kěnéng
*可是	kěshì
可謂	kěwèi
*可惜	kěxī
可笑	kěxiào
*可以	kěyǐ
渴望	kěwàng
*克	kè
*克服	kèfú
*刻	kè
刻畫	kèhuà
刻苦	kèkŭ
客	kè
*客觀	kèguān
客氣	kè·qi
*客人	kè·rén
客廳	kètīng
*課	kè
課本	kèběn
*課程	kèchéng
課堂	kètáng
*課題	kètí
肯	kěn
*肯定	kěndìng
啃	kěn
坑	kēng
*空	kōng
*空間	kōngjiān
空軍	kōngjūn
*空氣	kōngqì
空前	kōngqián
空虛	kōngxū
*空中	kōngzhōng
*孔	kŏng
孔雀	kŏngquè
恐怖	kŏngbù
恐慌	kŏnghuāng
恐懼	kŏngjù
*恐怕	kŏngpà
*空	kòng
空白	kòngbái
*控制	kòngzhì
*口	kŏu
口袋	kŏu·dai
*口號	kŏuhào
口腔	kŏuqiāng
口頭	kŏutóu
口語	kŏuyŭ
扣	kòu
*哭	kū
*苦	kŭ
苦難	kŭnàn
苦惱	kŭnǎo
庫	kù
庫存	kùcún
褲子	kù·zi
誇張	kuāzhāng
跨	kuà
*快	kuài
快活	kuài·huo
*快樂	kuàilè
快速	kuàisù
快要	kuàiyào
筷子	kuài·zi
*塊	kuài
*會計	kuài·jì
*寬	kuān
寬大	kuāndà
寬闊	kuānkuò
款	kuǎn
筐	kuāng
狂	kuáng
況且	kuàngqiě
*礦	kuàng
礦產	kuàngchǎn
礦物	kuàngwù
虧	kuī
虧損	kuīsŭn
*昆蟲	kūnchóng
捆	kŭn
困	kùn
困境	kùnjìng
*困難	kùn·nan
闊	kuò
*擴大	kuòdà
擴散	kuòsàn
擴展	kuòzhǎn
*擴張	kuòzhāng
*拉	lā
*拉	lá
喇叭	lǎ·ba
*落	là
辣椒	làjiāo
蠟	là
蠟燭	làzhú
*來	lái
來不及	lái·bùjí
來回	láihuí
來臨	láilín
來往	láiwǎng
*來信	láixìn
*來源	láiyuán
賴	lài
蘭	lán
欄	lán
*藍	lán
爛	làn
狼	láng
浪	làng
*浪費	làngfèi
浪花	lànghuā
撈	lāo
牢	láo
勞	láo
*勞動	láodòng
*勞動力	láodònglì
*勞動者	láodòngzhĕ
勞力	láolì
*老	lǎo
老百姓	lǎobǎixìng
老闆	lǎobǎn
老大	lǎodà
老虎	lǎohŭ
老年	lǎonián
*老婆	lǎo·po
*老人	lǎorén
老人家	lǎo·rén·jiā
*老師	lǎoshī
老實	lǎo·shi
老鼠	lǎo·shŭ
老太太	lǎotài·tai
老頭子	lǎotóu·zi
*老爺	lǎo·ye
老子	lǎo·zi
*落	lào
*樂	lè
樂觀	lèguān
雷	léi
雷達	léidá
*纍	léi
*纍	lĕi
*淚	lèi
淚水	lèishuǐ
*累	lèi
*類	lèi
*類似	lèisì
*類型	lèixíng
*冷	lěng
冷靜	lěngjìng
冷卻	lěngquè
冷水	lěngshuǐ
冷笑	lěngxiào
愣	lèng
梨	lí
犁	lí
*離	lí
*離婚	líhūn
*離開	líkāi
*離子	lízǐ
*李	lǐ
*理	lǐ
*理解	lǐjiě
*理論	lǐlùn
*理想	lǐxiǎng
*理性	lǐxìng
*理由	lǐyóu
理智	lǐzhì
*裏	lǐ
裏邊	lǐ·biān
*裏面	lǐ·miàn
裏頭	lǐ·tou
*禮	lǐ
禮貌	lǐmào
禮物	lǐwù
*力	lì
*力量	lì·liàng
力氣	lì·qi
力求	lìqiú
力圖	lìtú
*力學	lìxué
*立	lì
*立場	lìchǎng
*立法	lìfǎ
*立即	lìjí
*立刻	lìkè
立體	lìtǐ
*粒	lì
*粒子	lìzǐ
*利	lì
利害	lìhài
利率	lìlǜ
*利潤	lìrùn
利息	lìxī
*利益	lìyì
*利用	lìyòng
*利於	lìyú
*例	lì
*例如	lìrú
例外	lìwài
*例子	lì·zi
*厲害	lì·hai
歷	lì
歷代	lìdài
歷來	lìlái
*歷史	lìshǐ
倆	liǎ
*連	lián
*連接	liánjiē
連結	liánjié
*連忙	liánmáng
連同	liántóng
*連續	liánxù
蓮子	liánzǐ
廉價	liánjià
聯	lián
聯邦	liánbāng
*聯合	liánhé
聯合國	Liánhéguó
聯絡	liánluò
聯盟	liánméng
*聯繫	liánxì
*聯想	liánxiǎng
聯營	liányíng
*臉	liǎn
*臉色	liǎnsè
煉	liàn
*練	liàn
*練習	liànxí
鏈	liàn
戀愛	liàn'ài
良	liáng
*良好	liánghǎo
良心	liángxīn
梁	liáng
涼	liáng
*量	liáng
*糧	liáng
*糧食	liáng·shi
*兩	liǎng
兩岸	liǎng'àn
*兩邊	liǎngbiān
兩極	liǎngjí
兩旁	liǎngpáng
*亮	liàng
涼	liàng
*量	liàng
量子	liàngzǐ
*輛	liàng
遼闊	liáokuò
*了	liǎo
了不起	liǎo·bùqǐ
*了解	liǎojiě
*料	liào
咧	liě
*列	liè
列車	lièchē
列舉	lièjŭ
烈士	lièshì
裂	liè
獵	liè
*林	lín
林木	línmù
林業	línyè
淋	lín
淋巴	línbā
鄰	lín
鄰近	línjìn
鄰居	lín·jū
*磷	lín
臨	lín
*臨床	línchuáng
*臨時	línshí
鈴	líng
齡	líng
*零	líng
零件	língjiàn
零售	língshòu
*靈	líng
靈感	línggǎn
*靈魂	línghún
*靈活	línghuó
靈敏	língmǐn
*令	lǐng
*領	lǐng
*領導	lǐngdǎo
領會	lǐnghuì
領事	lǐngshì
*領土	lǐngtŭ
*領袖	lǐngxiù
*領域	lǐngyù
嶺	lǐng
*令	lìng
*另	lìng
*另外	lìngwài
溜	liū
*流	liú
流傳	liúchuán
*流動	liúdòng
流露	liúlù
流氓	liúmáng
流派	liúpài
流水	liúshuǐ
流體	liútǐ
*流通	liútōng
流向	liúxiàng
*流行	liúxíng
流血	liúxuè
流域	liúyù
硫	liú
*留	liú
留學	liúxué
瘤	liú
*劉	Liú
柳	liŭ
*六	liù
陸	liù
溜	liù
*龍	lóng
籠	lóng
*壟斷	lŏngduàn
攏	lŏng
籠	lŏng
籠罩	lŏngzhào
*弄	lòng
摟	lōu
*樓	lóu
樓房	lóufáng
摟	lŏu
漏	lòu
*露	lòu
爐	lú
爐子	lú·zi
鹵	lŭ
魯	lŭ
鹿	lù
陸	lù
*陸地	lùdì
陸軍	lùjūn
陸續	lùxù
*路	lù
路程	lùchéng
路過	lùguò
*路線	lùxiàn
路子	lù·zi
錄	lù
*露	lù
驢	lǘ
旅	lǚ
旅館	lǚguǎn
旅客	lǚkè
旅行	lǚxíng
旅遊	lǚyóu
*履行	lǚxíng
*鋁	lǚ
縷	lǚ
*律	lǜ
律師	lǜshī
*率	lǜ
氯	lǜ
氯氣	lǜqì
*綠	lǜ
綠化	lǜhuà
濾	lǜ
*卵	luǎn
卵巢	luǎncháo
*亂	luàn
掠奪	lüèduó
*略	lüè
倫理	lúnlǐ
*輪	lún
輪船	lúnchuán
輪廓	lúnkuò
輪流	lúnliú
*論	lùn
論點	lùndiǎn
*論述	lùnshù
*論文	lùnwén
論證	lùnzhèng
螺旋	luóxuán
*羅	luó
*邏輯	luó·jí
*落	luò
落地	luòdì
*落後	luòhòu
*落實	luòshí
絡	luò
駱駝	luò·tuo
*抹	mā
*媽媽	mā·ma
麻	má
麻煩	má·fan
麻醉	mázuì
*馬	mǎ
馬車	mǎchē
*馬路	mǎlù
*馬上	mǎshàng
碼	mǎ
碼頭	mǎ·tou
*螞蟻	mǎyǐ
*罵	mà
埋	mái
*買	mǎi
*買賣	mǎi·mai
脈	mài
麥	mài
*賣	mài
邁	mài
瞞	mán
饅頭	mán·tou
蠻	mán
*滿	mǎn
*滿意	mǎnyì
*滿足	mǎnzú
漫長	màncháng
*慢	màn
慢性	mànxìng
*忙	máng
忙碌	mánglù
*盲目	mángmù
茫然	mángrán
*貓	māo
*毛	máo
毛病	máo·bìng
毛巾	máojīn
*矛盾	máodùn
*冒	mào
冒險	màoxiǎn
帽	mào
*帽子	mào·zi
*貿易	màoyì
*沒	méi
沒事	méishì
*沒有	méi·yŏu
*枚	méi
眉	méi
眉毛	méi·mao
眉頭	méitóu
梅	méi
*煤	méi
煤炭	méitàn
媒介	méijiè
*每	měi
*每年	měinián
*美	měi
美感	měigǎn
*美好	měihǎo
美化	měihuà
*美麗	měilì
美妙	měimiào
*美術	měishù
*美學	měixué
*美元	Měiyuán
鎂	měi
*妹妹	mèi·mei
魅力	mèilì
悶	mēn
*門	mén
*門口	ménkŏu
悶	mèn
蒙	mēng
萌發	méngfā
萌芽	méngyá
蒙	méng
蒙	Měng
*猛	měng
猛烈	měngliè
孟	Mèng
*夢	mèng
迷	mí
迷人	mírén
迷信	míxìn
謎	mí
彌補	míbŭ
瀰漫	mímàn
*米	mǐ
*祕密	mìmì
祕書	mìshū
*密	mì
*密度	mìdù
密集	mìjí
*密切	mìqiè
蜜	mì
蜜蜂	mìfēng
*棉	mián
*棉花	mián·huā
免	miǎn
免疫	miǎnyì
勉強	miǎnqiǎng
*面	miàn
*面積	miànjī
面孔	miànkŏng
*面臨	miànlín
*面貌	miànmào
面目	miànmù
*面前	miànqián
*苗	miáo
*描繪	miáohuì
*描述	miáoshù
*描寫	miáoxiě
*秒	miǎo
妙	miào
廟	miào
*滅	miè
滅亡	mièwáng
*民	mín
民兵	mínbīng
民歌	míngē
民國	mínguó
*民間	mínjiān
民事	mínshì
民俗	mínsú
民衆	mínzhòng
*民主	mínzhŭ
*民族	mínzú
敏感	mǐngǎn
敏捷	mǐnjié
敏銳	mǐnruì
*名	míng
*名稱	míngchēng
*名詞	míngcí
名義	míngyì
*名字	míng·zi
*明	míng
*明白	míng·bai
明亮	míngliàng
明年	míngnián
*明確	míngquè
*明天	míngtiān
*明顯	míngxiǎn
鳴	míng
*命	mìng
*命令	mìnglìng
命名	mìngmíng
*命題	mìngtí
*命運	mìngyùn
*摸	mō
摸索	mō·suŏ
模	mó
模範	mófàn
*模仿	mófǎng
*模糊	mó·hu
模擬	mónǐ
*模式	móshì
*模型	móxíng
*膜	mó
摩	mó
摩擦	mócā
*磨	mó
*抹	mŏ
*末	mò
末期	mòqī
*抹	mò
*沒	mò
沒落	mòluò
沒收	mòshōu
陌生	mòshēng
*莫	mò
墨	mò
*默默	mòmò
*磨	mò
謀	móu
*某	mŏu
模樣	múyàng
*母	mŭ
*母親	mŭ·qīn
母體	mŭtǐ
*畝	mŭ
*木	mù
木材	mùcái
木頭	mù·tou
*目	mù
*目標	mùbiāo
*目的	mùdì
*目光	mùguāng
*目前	mùqián
墓	mù
幕	mù
*拿	ná
*哪	nǎ
*哪裏	nǎ·lǐ
*哪兒	nǎr
*哪些	nǎxiē
*那	nà
*那裏	nà·lǐ
*那麼	nà·me
*那兒	nàr
*那些	nàxiē
*那樣	nàyàng
納	nà
納入	nàrù
納稅	nàshuì
*鈉	nà
*乃	nǎi
乃至	nǎizhì
奶	nǎi
*奶奶	nǎi·nai
耐	nài
耐心	nàixīn
*男	nán
*男女	nánnǚ
*男人	nánrén
男性	nánxìng
*男子	nánzǐ
*南	nán
*南北	nánběi
*南方	nánfāng
南極	Nánjí
*難	nán
*難道	nándào
難得	nándé
難怪	nánguài
難過	nánguò
難免	nánmiǎn
難受	nánshòu
難題	nántí
*難以	nányǐ
難於	nányú
*難	nàn
*囊	náng
*腦	nǎo
*腦袋	nǎo·dai
*腦子	nǎo·zi
*鬧	nào
*內	nèi
*內部	nèibù
內地	nèidì
內涵	nèihán
*內容	nèiróng
內外	nèiwài
*內心	nèixīn
*內在	nèizài
內臟	nèizàng
嫩	nèn
*能	néng
*能夠	nénggòu
*能力	nénglì
*能量	néngliàng
*能源	néngyuán
*泥	ní
泥土	nítŭ
*你	nǐ
*你們	nǐ·men
擬	nǐ
逆	nì
*年	nián
年初	niánchū
*年代	niándài
年底	niándǐ
年度	niándù
年級	niánjí
*年紀	niánjì
*年間	niánjiān
*年齡	niánlíng
年青	niánqīng
*年輕	niánqīng
年頭兒	niántóur
*念	niàn
念頭	niàn·tou
*娘	niáng
*鳥	niǎo
尿	niào
捏	niē
*您	nín
寧	níng
寧靜	níngjìng
擰	níng
凝	níng
凝固	nínggù
凝結	níngjié
凝聚	níngjù
凝視	níngshì
擰	nǐng
寧	nìng
擰	nìng
*牛	niú
扭	niŭ
扭轉	niŭzhuǎn
*農	nóng
*農產品	nóngchǎnpǐn
農場	nóngchǎng
*農村	nóngcūn
農戶	nónghù
農具	nóngjù
*農民	nóngmín
農田	nóngtián
農藥	nóngyào
*農業	nóngyè
農作物	nóngzuòwù
*濃	nóng
*濃度	nóngdù
濃厚	nónghòu
*弄	nòng
*奴隸	núlì
*努力	nŭlì
怒	nù
*女	nǚ
*女兒	nǚ’ér
女工	nǚgōng
*女人	nǚrén
女士	nǚshì
*女性	nǚxìng
女婿	nǚ·xu
*女子	nǚzǐ
*暖	nuǎn
歐	Ōu
偶	ŏu
偶爾	ŏu'ěr
*偶然	ŏurán
偶然性	ŏuránxìng
扒	pá
*爬	pá
*怕	pà
*拍	pāi
拍攝	pāishè
*排	pái
*排斥	páichì
排除	páichú
排放	páifàng
*排列	páiliè
*牌	pái
牌子	pái·zi
*派	pài
派出所	pàichūsuŏ
派遣	pàiqiǎn
潘	Pān
攀	pān
*盤	pán
判	pàn
判處	pànchŭ
判定	pàndìng
*判斷	pànduàn
判決	pànjué
盼	pàn
盼望	pànwàng
*旁	páng
*旁邊	pángbiān
龐大	pángdà
*胖	pàng
*泡	pāo
拋	pāo
拋棄	pāoqì
炮	páo
*跑	pǎo
*泡	pào
炮	pào
炮彈	pàodàn
胚	pēi
胚胎	pēitāi
培訓	péixùn
*培養	péiyǎng
培育	péiyù
陪	péi
賠償	péicháng
佩服	pèi·fú
*配	pèi
*配合	pèihé
配套	pèitào
配置	pèizhì
噴	pēn
*盆	pén
盆地	péndì
*朋友	péng·you
棚	péng
彭	Péng
*膨脹	péngzhàng
蓬勃	péngbó
捧	pěng
*碰	pèng
*批	pī
*批發	pīfā
*批判	pīpàn
*批評	pīpíng
*批准	pīzhŭn
披	pī
*皮	pí
*皮膚	pífū
疲倦	píjuàn
疲勞	píláo
脾	pí
脾氣	pí·qi
*匹	pǐ
屁股	pì·gu
*譬如	pìrú
*偏	piān
偏見	piānjiàn
偏偏	piānpiān
偏向	piānxiàng
*篇	piān
便宜	pián·yi
*片	piàn
片刻	piànkè
片面	piànmiàn
騙	piàn
飄	piāo
票	piào
*漂亮	piào·liang
拼命	pīnmìng
貧	pín
貧困	pínkùn
貧窮	pínqióng
頻繁	pínfán
*頻率	pínlǜ
*品	pǐn
品德	pǐndé
*品質	pǐnzhì
*品種	pǐnzhŏng
乒乓球	pīngpāngqiú
*平	píng
*平常	píngcháng
*平等	píngděng
平凡	píngfán
平分	píngfēn
*平衡	pínghéng
*平靜	píngjìng
*平均	píngjūn
*平面	píngmiàn
平民	píngmín
平日	píngrì
*平時	píngshí
平坦	píngtǎn
*平行	píngxíng
*平原	píngyuán
評	píng
*評價	píngjià
*評論	pínglùn
評選	píngxuǎn
屏	píng
*瓶	píng
*憑	píng
憑藉	píngjiè
蘋果	píngguŏ
坡	pō
*頗	pō
婆婆	pó·po
迫	pò
迫害	pòhài
迫切	pòqiè
迫使	pòshǐ
*破	pò
破產	pòchǎn
*破壞	pòhuài
破裂	pòliè
撲	pū
*鋪	pū
菩薩	pú·sà
葡萄	pú·táo
葡萄糖	pú·táotáng
*普遍	pŭbiàn
普及	pŭjí
*普通	pŭtōng
普通話	Pŭtōnghuà
譜	pŭ
樸素	pŭsù
*鋪	pù
*七	qī
*妻子	qī·zi
淒涼	qīliáng
*期	qī
期待	qīdài
期貨	qīhuò
*期間	qījiān
期望	qīwàng
期限	qīxiàn
欺騙	qīpiàn
漆	qī
*其	qí
*其次	qícì
其間	qíjiān
*其實	qíshí
*其他	qítā
*其餘	qíyú
*其中	qízhōng
旗	qí
旗幟	qízhì
奇	qí
*奇怪	qíguài
奇跡	qíjì
奇特	qítè
奇異	qíyì
*騎	qí
*齊	qí
*企圖	qǐtú
*企業	qǐyè
*起	qǐ
起初	qǐchū
起點	qǐdiǎn
起伏	qǐfú
*起來	qǐ·lái
起碼	qǐmǎ
起身	qǐshēn
*起義	qǐyì
*起源	qǐyuán
*啓發	qǐfā
啓示	qǐshì
*汽車	qìchē
汽油	qìyóu
*氣	qì
*氣氛	qì·fēn
氣憤	qìfèn
*氣候	qìhòu
氣流	qìliú
*氣體	qìtǐ
氣團	qìtuán
氣味	qìwèi
*氣溫	qìwēn
氣息	qìxī
*氣象	qìxiàng
氣壓	qìyā
氣質	qìzhì
契約	qìyuē
砌	qì
棄	qì
*器	qì
器材	qìcái
*器官	qìguān
卡	qiǎ
恰當	qiàdàng
恰好	qiàhǎo
*千	qiān
千方百計	qiānfāngbǎijì
牽	qiān
鉛	qiān
鉛筆	qiānbǐ
遷	qiān
遷移	qiānyí
*簽訂	qiāndìng
*前	qián
前邊	qián·biān
前方	qiánfāng
*前後	qiánhòu
*前進	qiánjìn
前景	qiánjǐng
*前面	qián·miàn
前期	qiánqī
前人	qiánrén
*前提	qiántí
前頭	qián·tou
*前途	qiántú
前往	qiánwǎng
前夕	qiánxī
前線	qiánxiàn
潛	qián
潛力	qiánlì
潛在	qiánzài
*錢	qián
*淺	qiǎn
遣	qiǎn
欠	qiàn
嵌	qiàn
腔	qiāng
*槍	qiāng
*強	qiáng
*強大	qiángdà
強盜	qiángdào
*強調	qiángdiào
*強度	qiángdù
強化	qiánghuà
*強烈	qiángliè
強制	qiángzhì
*牆	qiáng
牆壁	qiángbì
*強	qiǎng
*搶	qiǎng
搶救	qiǎngjiù
*悄悄	qiāoqiāo
*敲	qiāo
*橋	qiáo
橋樑	qiáoliáng
*瞧	qiáo
巧	qiǎo
巧妙	qiǎomiào
殼	qiào
*切	qiē
*且	qiě
*切	qiè
切實	qièshí
侵	qīn
侵犯	qīnfàn
*侵略	qīnlüè
侵權	qīnquán
侵入	qīnrù
侵蝕	qīnshí
侵佔	qīnzhàn
*親	qīn
親密	qīnmì
親戚	qīn·qi
*親切	qīnqiè
親熱	qīnrè
親人	qīnrén
親屬	qīnshŭ
親眼	qīnyǎn
親友	qīnyŏu
*親自	qīnzì
*秦	Qín
琴	qín
勤	qín
勤勞	qínláo
*青	qīng
青春	qīngchūn
*青年	qīngnián
青蛙	qīngwā
*清	qīng
清晨	qīngchén
清除	qīngchú
*清楚	qīng·chu
清潔	qīngjié
清理	qīnglǐ
*清晰	qīngxī
清醒	qīngxǐng
*氫	qīng
*氫氣	qīngqì
*輕	qīng
輕工業	qīnggōngyè
輕聲	qīngshēng
輕視	qīngshì
輕鬆	qīngsōng
輕微	qīngwēi
輕易	qīngyì
輕重	qīngzhòng
傾	qīng
傾聽	qīngtīng
*傾向	qīngxiàng
傾斜	qīngxié
*情	qíng
*情報	qíngbào
情操	qíngcāo
*情感	qínggǎn
*情節	qíngjié
*情景	qíngjǐng
情境	qíngjìng
*情況	qíngkuàng
情趣	qíngqù
*情形	qíng·xíng
*情緒	qíng·xù
*請	qǐng
*請求	qǐngqiú
慶祝	qìngzhù
*窮	qióng
窮人	qióngrén
*秋	qiū
秋季	qiūjì
秋天	qiūtiān
*求	qiú
求證	qiúzhèng
*球	qiú
酋長	qiúzhǎng
*曲	qū
*曲線	qūxiàn
曲折	qūzhé
屈服	qūfú
*區	qū
*區別	qūbié
*區分	qūfēn
*區域	qūyù
驅	qū
驅逐	qūzhú
趨	qū
*趨勢	qūshì
趨向	qūxiàng
渠	qú
*曲	qŭ
*取	qŭ
取代	qŭdài
*取得	qŭdé
*取消	qŭxiāo
娶	qŭ
*去	qù
*去年	qùnián
去世	qùshì
趣味	qùwèi
*圈	quān
*全	quán
*全部	quánbù
全局	quánjú
*全面	quánmiàn
全民	quánmín
全球	quánqiú
*全身	quánshēn
*全體	quántǐ
泉	quán
拳	quán
拳頭	quán·tou
*權	quán
*權力	quánlì
*權利	quánlì
權威	quánwēi
權益	quányì
*勸	quàn
*缺	quē
*缺點	quēdiǎn
*缺乏	quēfá
*缺少	quēshǎo
缺陷	quēxiàn
*卻	què
確	què
確保	quèbǎo
*確定	quèdìng
*確立	quèlì
確切	quèqiè
確認	quèrèn
*確實	quèshí
*群	qún
群落	qúnluò
*群體	qúntǐ
*群衆	qúnzhòng
*然	rán
*然而	rán'ér
*然後	ránhòu
燃	rán
*燃料	ránliào
*燃燒	ránshāo
染	rǎn
染色	rǎnsè
嚷	rǎng
*讓	ràng
擾亂	rǎoluàn
*繞	rào
惹	rě
*熱	rè
*熱愛	rè'ài
*熱帶	rèdài
*熱量	rèliàng
*熱烈	rèliè
*熱鬧	rè·nao
熱能	rènéng
*熱情	rèqíng
熱心	rèxīn
*人	rén
*人才	réncái
*人格	réngé
*人工	réngōng
*人家	rénjiā
*人家	rén·jia
*人間	rénjiān
人均	rénjūn
*人口	rénkŏu
*人類	rénlèi
*人力	rénlì
*人們	rén·men
*人民	rénmín
人民幣	rénmínbì
*人群	rénqún
人身	rénshēn
*人生	rénshēng
人士	rénshì
人事	rénshì
*人體	réntǐ
人爲	rénwéi
*人物	rénwù
人心	rénxīn
人性	rénxìng
人影兒	rényǐngr
*人員	rényuán
人造	rénzào
仁	rén
*任	Rén
忍	rěn
忍耐	rěnnài
忍受	rěnshòu
*任	rèn
*任何	rènhé
任命	rènmìng
*任務	rèn·wù
*任意	rènyì
認	rèn
認定	rèndìng
*認識	rèn·shi
*認爲	rènwéi
*認真	rènzhēn
扔	rēng
*仍	réng
仍舊	réngjiù
*仍然	réngrán
*日	rì
日報	rìbào
日常	rìcháng
日記	rìjì
日期	rìqī
日前	rìqián
日趨	rìqū
日夜	rìyè
*日益	rìyì
*日子	rì·zi
容	róng
容量	róngliàng
容納	róngnà
容器	róngqì
*容易	róngyì
*溶	róng
溶劑	róngjì
*溶解	róngjiě
*溶液	róngyè
熔	róng
榮譽	róngyù
融合	rónghé
柔和	róuhé
柔軟	róuruǎn
揉	róu
*肉	ròu
肉體	ròutǐ
*如	rú
*如此	rúcǐ
*如果	rúguŏ
*如何	rúhé
*如今	rújīn
*如同	rútóng
*如下	rúxià
儒家	Rújiā
*乳	rŭ
*入	rù
入侵	rùqīn
入手	rùshŏu
入學	rùxué
*軟	ruǎn
*若	ruò
*若干	ruògān
若是	ruòshì
*弱	ruò
弱點	ruòdiǎn
撒	sā
灑	sǎ
撒	sǎ
塞	sāi
鰓	sāi
塞	sài
賽	sài
*三	sān
三角	sānjiǎo
*三角形	sānjiǎoxíng
傘	sǎn
*散	sǎn
散文	sǎnwén
*散	sàn
散佈	sànbù
散步	sànbù
散發	sànfā
嗓子	sǎng·zi
*喪失	sàngshī
掃	sǎo
掃蕩	sǎodàng
*色	sè
*色彩	sècǎi
塞	sè
*森林	sēnlín
僧	sēng
僧侶	sēnglǚ
*沙	shā
沙發	shāfā
*沙漠	shāmò
沙灘	shātān
砂	shā
紗	shā
*殺	shā
殺害	shāhài
傻	shǎ
*色	shǎi
曬	shài
*山	shān
山地	shāndì
山峰	shānfēng
山谷	shāngŭ
山林	shānlín
山路	shānlù
山脈	shānmài
*山區	shānqū
山水	shānshuǐ
山頭	shāntóu
*扇	shān
*閃	shǎn
閃電	shǎndiàn
閃光	shǎnguāng
閃爍	shǎnshuò
*扇	shàn
*單	Shàn
*善	shàn
善良	shànliáng
*善於	shànyú
*商	shāng
商標	shāngbiāo
*商店	shāngdiàn
*商量	shāng·liang
*商品	shāngpǐn
*商人	shāngrén
*商業	shāngyè
*傷	shāng
傷害	shānghài
傷口	shāngkŏu
傷心	shāngxīn
*上	shǎng
賞	shǎng
*上	shàng
上班	shàngbān
上邊	shàng·biān
上層	shàngcéng
*上帝	Shàngdì
*上級	shàngjí
上課	shàngkè
上空	shàngkōng
*上來	shàng·lái
*上面	shàng·miàn
*上去	shàng·qù
上山	shàngshān
*上升	shàngshēng
上市	shàngshì
*上述	shàngshù
上訴	shàngsù
*上午	shàngwŭ
*上下	shàngxià
上學	shàngxué
上衣	shàngyī
上游	shàngyóu
上漲	shàngzhǎng
*尚	shàng
*梢	shāo
*稍	shāo
稍稍	shāoshāo
稍微	shāowēi
*燒	shāo
*少	shǎo
*少量	shǎoliàng
*少數	shǎoshù
*少	shào
*少年	shàonián
少女	shàonǚ
少爺	shào·ye
*舌	shé
舌頭	shé·tou
*折	shé
*蛇	shé
捨	shě
捨不得	shě·bù·dé
*社	shè
*社會	shèhuì
*社會學	shèhuìxué
舍	shè
射	shè
射擊	shèjī
*射線	shèxiàn
*涉及	shèjí
*設	shè
*設備	shèbèi
設法	shèfǎ
*設計	shèjì
*設立	shèlì
*設施	shèshī
*設想	shèxiǎng
*設置	shèzhì
攝	shè
攝影	shèyǐng
*誰	shéi
申請	shēnqǐng
*伸	shēn
伸手	shēnshŏu
*身	shēn
*身邊	shēnbiān
身材	shēncái
*身份	shēn·fèn
身後	shēnhòu
身軀	shēnqū
*身體	shēntǐ
身心	shēnxīn
身影	shēnyǐng
*身子	shēn·zi
參	shēn
*深	shēn
深沉	shēnchén
*深度	shēndù
深厚	shēnhòu
深化	shēnhuà
*深刻	shēnkè
深情	shēnqíng
*深入	shēnrù
深夜	shēnyè
深遠	shēnyuǎn
*神	shén
*神話	shénhuà
*神經	shénjīng
*神祕	shénmì
神奇	shénqí
神氣	shén·qì
神情	shénqíng
神色	shénsè
神聖	shénshèng
神態	shéntài
神學	shénxué
*甚麼	shén·me
沈	Shěn
嬸	shěn
審查	shěnchá
*審美	shěnměi
*審判	shěnpàn
*甚	shèn
*甚至	shènzhì
*腎	shèn
慎重	shènzhòng
*滲透	shèntòu
*升	shēng
*生	shēng
*生產	shēngchǎn
*生產力	shēngchǎnlì
*生成	shēngchéng
*生存	shēngcún
*生動	shēngdòng
*生活	shēnghuó
*生理	shēnglǐ
*生命	shēngmìng
生命力	shēngmìnglì
*生氣	shēngqì
生前	shēngqián
生態	shēngtài
*生物	shēngwù
生意	shēngyì
生意	shēng·yi
生育	shēngyù
*生長	shēngzhǎng
*生殖	shēngzhí
牲畜	shēngchù
牲口	shēng·kou
*聲	shēng
聲調	shēngdiào
聲明	shēngmíng
聲響	shēngxiǎng
*聲音	shēngyīn
繩	shéng
繩子	shéng·zi
*省	shěng
*盛	shèng
盛行	shèngxíng
剩	shèng
剩餘	shèngyú
*勝	shèng
*勝利	shènglì
聖	shèng
聖經	Shèngjīng
*失	shī
*失敗	shībài
失掉	shīdiào
*失去	shīqù
失調	shītiáo
*失望	shīwàng
失誤	shīwù
失業	shīyè
屍體	shītǐ
*施	shī
施工	shīgōng
施行	shīxíng
*師	shī
師範	shīfàn
*師傅	shī·fu
師長	shīzhǎng
*詩	shī
詩歌	shīgē
*詩人	shīrén
詩意	shīyì
*溼	shī
溼度	shīdù
溼潤	shīrùn
*十	shí
*石	shí
石灰	shíhuī
*石頭	shí·tou
*石油	shíyóu
拾	shí
*食	shí
*食品	shípǐn
食堂	shítáng
*食物	shíwù
食鹽	shíyán
食用	shíyòng
*時	shí
時常	shícháng
*時代	shídài
時而	shí'ér
*時候	shí·hou
時機	shíjī
*時間	shíjiān
時節	shíjié
*時刻	shíkè
時空	shíkōng
時髦	shímáo
*時期	shíqī
*實	shí
*實際	shíjì
*實踐	shíjiàn
實力	shílì
實例	shílì
*實施	shíshī
實體	shítǐ
*實物	shíwù
*實現	shíxiàn
*實行	shíxíng
*實驗	shíyàn
實用	shíyòng
*實在	shízài
*實在	shí·zai
*實質	shízhì
識	shí
識別	shíbié
識字	shízì
*史	shǐ
史學	shǐxué
*使	shǐ
*使得	shǐ·dé
使勁	shǐjìn
使命	shǐmìng
*使用	shǐyòng
*始	shǐ
*始終	shǐzhōng
士	shì
士兵	shìbīng
*氏	shì
*氏族	shìzú
*世	shì
世代	shìdài
*世紀	shìjì
*世界	shìjiè
*世界觀	shìjièguān
*示	shì
示範	shìfàn
示威	shìwēi
*市	shì
*市場	shìchǎng
市民	shìmín
*式	shì
*試	shì
試圖	shìtú
*試驗	shìyàn
*似的	shì·de
*事	shì
*事故	shìgù
事後	shìhòu
事跡	shìjì
*事件	shìjiàn
事例	shìlì
*事情	shì·qing
*事實	shìshí
*事物	shìwù
事務	shìwù
事先	shìxiān
*事業	shìyè
*室	shì
*是	shì
是非	shìfēi
*是否	shìfŏu
逝世	shìshì
*視	shì
視覺	shìjué
視線	shìxiàn
視野	shìyě
*勢	shì
勢必	shìbì
*勢力	shì·lì
適	shì
*適當	shìdàng
*適合	shìhé
*適宜	shìyí
*適應	shìyìng
*適用	shìyòng
*釋放	shìfàng
*收	shōu
*收購	shōugòu
收回	shōuhuí
收穫	shōuhuò
*收集	shōují
*收入	shōurù
收拾	shōu·shi
*收縮	shōusuō
收益	shōuyì
收音機	shōuyīnjī
*熟	shóu
*手	shŏu
手臂	shŏubì
手錶	shŏubiǎo
*手段	shŏuduàn
*手法	shŏufǎ
手工	shŏugōng
手腳	shŏujiǎo
手榴彈	shŏuliúdàn
手槍	shŏuqiāng
手勢	shŏushì
*手術	shŏushù
手續	shŏuxù
手掌	shŏuzhǎng
*手指	shŏuzhǐ
*守	shŏu
*首	shŏu
*首都	shŏudū
首領	shŏulǐng
*首先	shŏuxiān
首要	shŏuyào
首長	shŏuzhǎng
*受	shòu
受傷	shòushāng
授	shòu
狩獵	shòuliè
壽命	shòumìng
*瘦	shòu
獸	shòu
抒情	shūqíng
*叔叔	shū·shu
*書	shū
書包	shūbāo
書本	shūběn
書籍	shūjí
*書記	shū·jì
書面	shūmiàn
書寫	shūxiě
梳	shū
疏	shū
*蔬菜	shūcài
舒服	shū·fu
舒適	shūshì
輸	shū
輸出	shūchū
輸入	shūrù
輸送	shūsòng
*熟	shú
熟練	shúliàn
*熟悉	shú·xī
鼠	shŭ
*數	shŭ
*屬	shŭ
*屬性	shŭxìng
*屬於	shŭyú
*束	shù
*束縛	shùfù
述	shù
術	shù
術語	shùyŭ
*數	shù
*數據	shùjù
*數量	shùliàng
*數目	shùmù
*數學	shùxué
數值	shùzhí
*數字	shùzì
豎	shù
*樹	shù
樹幹	shùgàn
*樹立	shùlì
樹林	shùlín
*樹木	shùmù
樹種	shùzhŏng
刷	shuā
耍	shuǎ
衰老	shuāilǎo
摔	shuāi
甩	shuǎi
*率	shuài
*率領	shuàilǐng
拴	shuān
霜	shuāng
*雙	shuāng
*雙方	shuāngfāng
*誰	shuí
*水	shuǐ
*水分	shuǐfèn
水果	shuǐguŏ
水庫	shuǐkù
水利	shuǐlì
水流	shuǐliú
*水面	shuǐmiàn
水泥	shuǐní
*水平	shuǐpíng
水手	shuǐshŏu
水位	shuǐwèi
水文	shuǐwén
水銀	shuǐyín
水源	shuǐyuán
水蒸氣	shuǐzhēngqì
*稅	shuì
稅收	shuìshōu
*睡	shuì
*睡覺	shuìjiào
睡眠	shuìmián
順	shùn
*順利	shùnlì
順手	shùnshŏu
*順序	shùnxù
瞬間	shùnjiān
*說	shuō
*說法	shuō·fǎ
說服	shuōfú
*說話	shuōhuà
*說明	shuōmíng
司	sī
司法	sīfǎ
司機	sījī
司令	sīlìng
私	sī
*私人	sīrén
私營	sīyíng
私有	sīyŏu
思	sī
思潮	sīcháo
*思考	sīkǎo
思路	sīlù
*思索	sīsuŏ
*思維	sīwéi
*思想	sīxiǎng
思想家	sīxiǎngjiā
斯	sī
*絲	sī
絲毫	sīháo
*死	sǐ
*死亡	sǐwáng
死刑	sǐxíng
*四	sì
四處	sìchù
四面	sìmiàn
四肢	sìzhī
*四周	sìzhōu
*似	sì
*似乎	sì·hū
寺	sì
寺院	sìyuàn
*飼料	sìliào
飼養	sìyǎng
*鬆	sōng
*宋	Sòng
送	sòng
搜集	sōují
艘	sōu
*蘇	sū
俗	sú
俗稱	súchēng
速	sù
*速度	sùdù
*素	sù
素材	sùcái
*素質	sùzhì
宿	sù
宿舍	sùshè
訴訟	sùsòng
*塑料	sùliào
*塑造	sùzào
*酸	suān
*算	suàn
*雖	suī
*雖然	suīrán
雖說	suīshuō
*遂	suí
隋	Suí
*隨	suí
*隨便	suíbiàn
*隨後	suíhòu
隨即	suíjí
*隨時	suíshí
隨意	suíyì
髓	suǐ
碎	suì
*遂	suì
*歲	suì
歲月	suìyuè
穗	suì
*孫	sūn
孫子	sūn·zi
*損害	sŭnhài
損耗	sŭnhào
損傷	sŭnshāng
*損失	sŭnshī
縮	suō
縮短	suōduǎn
*縮小	suōxiǎo
*所	suŏ
所屬	suŏshŭ
*所謂	suŏwèi
*所以	suŏyǐ
*所有	suŏyŏu
*所有制	suŏyŏuzhì
*所在	suŏzài
索	suŏ
鎖	suŏ
*他	tā
*他們	tā·men
*他人	tārén
*她	tā
*她們	tā·men
牠	tā
牠們	tā·men
*它	tā
*它們	tā·men
*塔	tǎ
*踏	tà
胎	tāi
胎兒	tāi'ér
*臺	tái
*擡	tái
擡頭	táitóu
颱風	táifēng
*太	tài
太空	tàikōng
太平	tàipíng
*太太	tài·tai
*太陽	tài·yáng
太陽能	tàiyángnéng
太陽系	tàiyángxì
*態	tài
*態度	tài·dù
攤	tān
灘	tān
痰	tán
*談	tán
*談話	tánhuà
談論	tánlùn
談判	tánpàn
*彈	tán
彈性	tánxìng
坦克	tǎnkè
探	tàn
探測	tàncè
*探索	tànsuŏ
*探討	tàntǎo
*嘆	tàn
嘆息	tànxī
*碳	tàn
*湯	tāng
*唐	táng
塘	táng
*糖	táng
堂	táng
倘若	tǎngruò
*躺	tǎng
*趟	tàng
燙	tàng
掏	tāo
逃	táo
逃避	táobì
逃跑	táopǎo
逃走	táozŏu
桃	táo
陶	táo
陶冶	táoyě
淘汰	táotài
討	tǎo
*討論	tǎolùn
討厭	tǎoyàn
*套	tào
*特	tè
*特別	tèbié
特地	tèdì
*特點	tèdiǎn
*特定	tèdìng
特權	tèquán
*特色	tèsè
*特殊	tèshū
*特性	tèxìng
特意	tèyì
*特徵	tèzhēng
疼	téng
疼痛	téngtòng
藤	téng
踢	tī
*提	tí
*提倡	tíchàng
*提高	tígāo
*提供	tígōng
提煉	tíliàn
*提起	tíqǐ
提前	tíqián
提取	tíqŭ
提醒	tíxǐng
提議	tíyì
*題	tí
*題材	tícái
題目	tímù
*體	tǐ
體裁	tǐcái
體操	tǐcāo
*體會	tǐhuì
*體積	tǐjī
體力	tǐlì
體溫	tǐwēn
*體系	tǐxì
*體現	tǐxiàn
*體驗	tǐyàn
*體育	tǐyù
*體制	tǐzhì
體質	tǐzhì
體重	tǐzhòng
*替	tì
替代	tìdài
*天	tiān
天才	tiāncái
*天地	tiāndì
天鵝	tiān'é
*天空	tiānkōng
*天氣	tiānqì
*天然	tiānrán
天然氣	tiānránqì
天生	tiānshēng
*天體	tiāntǐ
天文	tiānwén
*天下	tiānxià
天真	tiānzhēn
天主教	Tiānzhŭjiào
添	tiān
*田	tián
田地	tiándì
田野	tiányě
*甜	tián
*填	tián
*挑	tiāo
挑選	tiāoxuǎn
*條	tiáo
*條件	tiáojiàn
條款	tiáokuǎn
*條例	tiáolì
*條約	tiáoyuē
*調	tiáo
調和	tiáohé
*調節	tiáojié
調解	tiáojiě
*調整	tiáozhěng
*挑	tiǎo
挑戰	tiǎozhàn
*跳	tiào
跳動	tiàodòng
跳舞	tiàowŭ
跳躍	tiàoyuè
*貼	tiē
*鐵	tiě
*鐵路	tiělù
*聽	tīng
聽話	tīnghuà
*聽見	tīng·jiàn
聽覺	tīngjué
聽取	tīngqŭ
聽衆	tīngzhòng
廳	tīng
*停	tíng
停頓	tíngdùn
停留	tíngliú
*停止	tíngzhǐ
*挺	tǐng
*通	tōng
*通常	tōngcháng
通道	tōngdào
通電	tōngdiàn
*通過	tōngguò
通紅	tōnghóng
通信	tōngxìn
*通訊	tōngxùn
通用	tōngyòng
*通知	tōngzhī
*同	tóng
同伴	tóngbàn
同胞	tóngbāo
同等	tóngděng
同行	tóngháng
同化	tónghuà
同類	tónglèi
同年	tóngnián
同期	tóngqī
*同情	tóngqíng
*同時	tóngshí
同事	tóngshì
同行	tóngxíng
*同學	tóngxué
*同樣	tóngyàng
*同意	tóngyì
*同志	tóngzhì
*銅	tóng
童話	tónghuà
童年	tóngnián
桶	tŏng
統	tŏng
*統計	tŏngjì
*統一	tŏngyī
*統治	tŏngzhì
筒	tŏng
*通	tòng
*痛	tòng
*痛苦	tòngkŭ
痛快	tòng·kuài
*偷	tōu
偷偷	tōutōu
投	tóu
投產	tóuchǎn
投機	tóujī
*投入	tóurù
投降	tóuxiáng
*投資	tóuzī
*頭	tóu
頭頂	tóudǐng
*頭髮	tóu·fa
*頭腦	tóunǎo
*透	tòu
透鏡	tòujìng
透露	tòulù
*透明	tòumíng
凸	tū
突	tū
突變	tūbiàn
*突出	tūchū
突擊	tūjī
*突破	tūpò
*突然	tūrán
徒	tú
*途徑	tújìng
塗	tú
屠殺	túshā
*圖	tú
圖案	tú'àn
圖畫	túhuà
圖書	túshū
*圖書館	túshūguǎn
圖形	túxíng
圖紙	túzhǐ
*土	tŭ
*土地	tŭdì
土匪	tŭfěi
*土壤	tŭrǎng
*吐	tŭ
*吐	tù
兔子	tù·zi
湍流	tuānliú
*團	tuán
*團結	tuánjié
*團體	tuántǐ
團員	tuányuán
*推	tuī
推測	tuīcè
*推動	tuīdòng
*推翻	tuīfān
*推廣	tuīguǎng
推薦	tuījiàn
推進	tuījìn
推理	tuīlǐ
推論	tuīlùn
推銷	tuīxiāo
*推行	tuīxíng
*腿	tuǐ
*退	tuì
退出	tuìchū
退化	tuìhuà
退休	tuìxiū
*托	tuō
*拖	tuō
*拖拉機	tuōlājī
*脫	tuō
*脫離	tuōlí
脫落	tuōluò
妥協	tuŏxié
*挖	wā
挖掘	wājué
娃娃	wá·wa
瓦	wǎ
歪	wāi
歪曲	wāiqū
*外	wài
外邊	wài·biān
外表	wàibiǎo
*外部	wàibù
外地	wàidì
*外國	wàiguó
外匯	wàihuì
外交	wàijiāo
*外界	wàijiè
外科	wàikē
外來	wàilái
外力	wàilì
外貿	wàimào
*外面	wài·miàn
外商	wàishāng
外形	wàixíng
外語	wàiyŭ
外在	wàizài
外資	wàizī
*彎	wān
彎曲	wānqū
*完	wán
完備	wánbèi
完畢	wánbì
*完成	wánchéng
完美	wánměi
*完全	wánquán
*完善	wánshàn
*完整	wánzhěng
*玩	wán
玩具	wánjù
玩笑	wánxiào
頑強	wánqiáng
挽	wǎn
*晚	wǎn
晚飯	wǎnfàn
晚期	wǎnqī
*晚上	wǎn·shang
*碗	wǎn
*萬	wàn
萬物	wànwù
萬一	wànyī
汪	wāng
亡	wáng
*王	wáng
王朝	wángcháo
王國	wángguó
*往	wǎng
往來	wǎnglái
*往往	wǎngwǎng
*網	wǎng
*忘	wàng
*忘記	wàngjì
旺	wàng
旺盛	wàngshèng
*望	wàng
望遠鏡	wàngyuǎnjìng
*危害	wēihài
*危機	wēijī
*危險	wēixiǎn
威力	wēilì
*威脅	wēixié
威信	wēixìn
*微	wēi
微觀	wēiguān
微粒	wēilì
微弱	wēiruò
微生物	wēishēngwù
*微微	wēiwēi
微小	wēixiǎo
*微笑	wēixiào
*爲	wéi
爲難	wéinán
爲人	wéirén
爲首	wéishŏu
*爲止	wéizhǐ
唯	wéi
惟	wéi
*維持	wéichí
*維護	wéihù
維生素	wéishēngsù
維新	wéixīn
維修	wéixiū
*圍	wéi
圍勦	wéijiǎo
*圍繞	wéirào
違背	wéibèi
違法	wéifǎ
*違反	wéifǎn
*尾	wěi
*尾巴	wěi·ba
委屈	wěi·qu
委託	wěituō
*委員	wěiyuán
*委員會	wěiyuánhuì
*偉大	wěidà
緯	wěi
緯度	wěidù
僞	wěi
*未	wèi
未必	wèibì
未曾	wèicéng
*未來	wèilái
*味	wèi
味道	wèi·dào
*位	wèi
*位置	wèizhì
*胃	wèi
*謂	wèi
*喂	wèi
*爲	wèi
爲何	wèihé
*爲了	wèi·le
衛	wèi
*衛生	wèishēng
*衛星	wèixīng
魏	Wèi
*溫	wēn
溫帶	wēndài
*溫度	wēndù
溫度計	wēndùjì
溫和	wēnhé
*溫暖	wēnnuǎn
溫柔	wēnróu
*文	wén
*文化	wénhuà
*文件	wénjiàn
*文明	wénmíng
文人	wénrén
文物	wénwù
*文獻	wénxiàn
*文學	wénxué
*文藝	wényì
*文章	wénzhāng
*文字	wénzì
紋	wén
蚊子	wén·zi
*聞	wén
吻	wěn
穩	wěn
*穩定	wěndìng
*問	wèn
問世	wènshì
*問題	wèntí
窩	wō
*我	wŏ
*我們	wŏ·men
臥	wò
臥室	wòshì
握	wò
握手	wòshŏu
*污染	wūrǎn
烏龜	wūguī
*屋	wū
*屋子	wū·zi
吾	wú
*吳	Wú
*無	wú
無比	wúbǐ
無從	wúcóng
*無法	wúfǎ
無非	wúfēi
無關	wúguān
無機	wújī
無可奈何	wúkěnàihé
無力	wúlì
*無論	wúlùn
無情	wúqíng
無窮	wúqióng
無聲	wúshēng
*無數	wúshù
*無限	wúxiàn
無線電	wúxiàndiàn
無效	wúxiào
無形	wúxíng
*無疑	wúyí
無意	wúyì
無知	wúzhī
*五	wŭ
武	wŭ
武力	wŭlì
*武器	wŭqì
*武裝	wŭzhuāng
侮辱	wŭrŭ
*舞	wŭ
*舞蹈	wŭdǎo
舞劇	wŭjù
*舞臺	wŭtái
勿	wù
*物	wù
物化	wùhuà
*物價	wùjià
*物理	wùlǐ
物力	wùlì
物品	wùpǐn
*物體	wùtǐ
*物質	wùzhì
物種	wùzhŏng
*物資	wùzī
務	wù
誤	wù
誤差	wùchā
誤會	wùhuì
誤解	wùjiě
*惡	wù
*霧	wù
*西	xī
*西北	xīběi
*西方	xīfāng
西瓜	xī·guā
*西南	xīnán
*西歐	XīŌu
*吸	xī
吸附	xīfù
吸取	xīqŭ
*吸收	xīshōu
*吸引	xīyǐn
*希望	xīwàng
*稀	xī
稀少	xīshǎo
息	xī
熄滅	xīmiè
鍚	xī
犧牲	xīshēng
席	xí
習	xí
*習慣	xíguàn
習俗	xísú
習性	xíxìng
*媳婦	xí·fù
襲擊	xíjī
*洗	xǐ
洗澡	xǐzǎo
*喜	xǐ
*喜愛	xǐ'ài
*喜歡	xǐ·huan
喜劇	xǐjù
喜悅	xǐyuè
*系	xì
系列	xìliè
*系統	xìtŏng
係數	xìshù
*細	xì
*細胞	xìbāo
細節	xìjié
*細菌	xìjūn
細小	xìxiǎo
細心	xìxīn
細緻	xìzhì
*戲	xì
*戲劇	xìjù
*戲曲	xìqŭ
瞎	xiā
蝦	xiā
狹	xiá
狹隘	xiá'ài
狹義	xiáyì
狹窄	xiázhǎi
*下	xià
下班	xiàbān
下邊	xià·biān
下層	xiàcéng
下達	xiàdá
下級	xiàjí
*下降	xiàjiàng
*下來	xià·lái
*下列	xiàliè
下令	xiàlìng
下落	xiàluò
*下面	xià·miàn
*下去	xia·qù
下屬	xiàshŭ
*下午	xiàwŭ
下旬	xiàxún
下游	xiàyóu
*夏	xià
*夏季	xiàjì
*夏天	xiàtiān
*嚇	xià
*先	xiān
*先後	xiānhòu
*先進	xiānjìn
先前	xiānqián
*先生	xiān·sheng
先天	xiāntiān
仙	xiān
掀起	xiānqǐ
鮮	xiān
鮮花	xiānhuā
*鮮明	xiānmíng
鮮血	xiānxuè
鮮艷	xiānyàn
*纖維	xiānwéi
*弦	xián
閒	xián
嫌	xián
銜	xián
鹹	xián
險	xiǎn
鮮	xiǎn
顯	xiǎn
*顯得	xiǎn·dé
顯露	xiǎnlù
*顯然	xiǎnrán
*顯示	xiǎnshì
顯微鏡	xiǎnwēijìng
顯現	xiǎnxiàn
*顯著	xiǎnzhù
限	xiàn
*限度	xiàndù
限於	xiànyú
*限制	xiànzhì
陷	xiàn
*陷入	xiànrù
陷於	xiànyú
*現	xiàn
現場	xiànchǎng
現存	xiàncún
*現代	xiàndài
*現代化	xiàndàihuà
現今	xiànjīn
現金	xiànjīn
*現實	xiànshí
*現象	xiànxiàng
現行	xiànxíng
*現在	xiànzài
現狀	xiànzhuàng
腺	xiàn
*線	xiàn
線路	xiànlù
*線圈	xiànquān
線索	xiànsuŏ
線條	xiàntiáo
羨慕	xiànmù
*憲法	xiànfǎ
*縣	xiàn
縣城	xiànchéng
獻	xiàn
獻身	xiànshēn
*相	xiāng
*相當	xiāngdāng
*相等	xiāngděng
*相對	xiāngduì
*相反	xiāngfǎn
*相關	xiāngguān
*相互	xiānghù
相繼	xiāngjì
相交	xiāngjiāo
相近	xiāngjìn
相連	xiānglián
*相似	xiāngsì
相通	xiāngtōng
*相同	xiāngtóng
*相信	xiāngxìn
*相應	xiāngyìng
箱	xiāng
箱子	xiāng·zi
*香	xiāng
香菸	xiāngyān
*鄉	xiāng
*鄉村	xiāngcūn
鄉下	xiāng·xia
降	xiáng
*詳細	xiángxì
享	xiǎng
*享受	xiǎngshòu
*享有	xiǎngyŏu
*想	xiǎng
*想法	xiǎng·fǎ
想像	xiǎngxiàng
想像力	xiǎngxiànglì
*響	xiǎng
響聲	xiǎngshēng
響應	xiǎngyìng
*向	xiàng
向來	xiànglái
*向上	xiàngshàng
嚮往	xiàngwǎng
*相	xiàng
*象	xiàng
*象徵	xiàngzhēng
*像	xiàng
橡膠	xiàngjiāo
橡皮	xiàngpí
*項	xiàng
*項目	xiàngmù
削	xiāo
消	xiāo
*消除	xiāochú
消毒	xiāodú
*消費	xiāofèi
消費品	xiāofèipǐn
*消耗	xiāohào
*消化	xiāohuà
*消極	xiāojí
*消滅	xiāomiè
*消失	xiāoshī
*消息	xiāo·xi
銷	xiāo
*銷售	xiāoshòu
*小	xiǎo
小兒	xiǎo'ér
*小夥子	xiǎohuŏ·zi
*小姐	xiǎo·jiĕ
*小麥	xiǎomài
小朋友	xiǎopéng·you
*小時	xiǎoshí
*小說兒	xiǎoshuōr
小心	xiǎo·xīn
小型	xiǎoxíng
*小學	xiǎoxué
小學生	xiǎoxuéshēng
小子	xiǎo·zi
*小組	xiǎozŭ
*曉得	xiǎo·dé
效	xiào
*效果	xiàoguŏ
效力	xiàolì
*效率	xiàolǜ
*效益	xiàoyì
*效應	xiàoyìng
*校	xiào
*校長	xiàozhǎng
*笑	xiào
笑話	xiào·hua
笑話兒	xiào·huar
笑容	xiàoróng
*些	xiē
歇	xiē
邪	xié
協定	xiédìng
協會	xiéhuì
協商	xiéshāng
*協調	xiétiáo
協同	xiétóng
協議	xiéyì
協助	xiézhù
*協作	xiézuò
*斜	xié
*鞋	xié
攜帶	xiédài
*血	xiě
*寫	xiě
*寫作	xiězuò
泄	xiè
謝	xiè
*謝謝	xiè·xie
*解	xiè
蟹	xiè
*心	xīn
心底	xīndǐ
*心理	xīnlǐ
*心裏	xīn·lǐ
*心靈	xīnlíng
*心情	xīnqíng
心事	xīnshì
心思	xīn·si
心頭	xīntóu
心血	xīnxuè
*心臟	xīnzàng
辛苦	xīnkŭ
辛勤	xīnqín
*新	xīn
新陳代謝	xīnchéndàixiè
新娘	xīnniáng
新奇	xīnqí
新人	xīnrén
新式	xīnshì
*新聞	xīnwén
*新鮮	xīn·xiān
*新興	xīnxīng
新型	xīnxíng
新穎	xīnyǐng
鋅	xīn
*欣賞	xīnshǎng
*信	xìn
信貸	xìndài
*信號	xìnhào
信念	xìnniàn
信任	xìnrèn
信徒	xìntú
*信息	xìnxī
*信心	xìnxīn
*信仰	xìnyǎng
信用	xìnyòng
*星	xīng
星際	xīngjì
*星期	xīngqī
星球	xīngqiú
星星	xīng·xing
興	xīng
*興奮	xīngfèn
興建	xīngjiàn
興起	xīngqǐ
刑	xíng
刑罰	xíngfá
刑法	xíngfǎ
刑事	xíngshì
*型	xíng
*形	xíng
*形成	xíngchéng
形容	xíngróng
*形式	xíngshì
*形勢	xíngshì
*形態	xíngtài
形體	xíngtǐ
*形象	xíngxiàng
*形狀	xíngzhuàng
*行	xíng
*行動	xíngdòng
行軍	xíngjūn
行李	xíng·li
行人	xíngrén
*行使	xíngshǐ
行駛	xíngshǐ
*行爲	xíngwéi
*行星	xíngxīng
*行政	xíngzhèng
行走	xíngzŏu
*省	xǐng
*醒	xǐng
*姓	xìng
姓名	xìngmíng
*性	xìng
性別	xìngbié
*性格	xìnggé
*性能	xìngnéng
性情	xìngqíng
*性質	xìngzhì
性狀	xìngzhuàng
*幸福	xìngfú
興	xìng
*興趣	xìngqù
凶	xiōng
兄	xiōng
*兄弟	xiōngdì
*兄弟	xiōng·di
*胸	xiōng
胸脯	xiōngpú
*雄	xióng
雄偉	xióngwěi
熊	xióng
*休息	xiū·xi
*修	xiū
修辭	xiūcí
修復	xiūfù
*修改	xiūgǎi
修建	xiūjiàn
修理	xiūlǐ
*修養	xiūyǎng
修正	xiūzhèng
宿	xiŭ
袖	xiù
臭	xiù
嗅	xiù
宿	xiù
繡	xiù
*虛	xū
*須	xū
*需	xū
*需求	xūqiú
*需要	xūyào
*徐	xú
許	xŭ
*許多	xŭduō
許可	xŭkě
序	xù
*畜	xù
*敘述	xùshù
*宣佈	xuānbù
*宣傳	xuānchuán
宣告	xuāngào
宣言	xuānyán
宣揚	xuānyáng
旋	xuán
旋律	xuánlǜ
*旋轉	xuánzhuǎn
懸	xuán
懸掛	xuánguà
*選	xuǎn
選拔	xuǎnbá
*選舉	xuǎnjŭ
選手	xuǎnshŏu
選用	xuǎnyòng
*選擇	xuǎnzé
旋	xuàn
削	xuē
削弱	xuēruò
穴	xué
*學	xué
*學會	xuéhuì
*學科	xuékē
學派	xuépài
*學生	xué·sheng
*學術	xuéshù
*學說	xuéshuō
學堂	xuétáng
學徒	xuétú
學問	xué·wen
*學習	xuéxí
*學校	xuéxiào
學員	xuéyuán
學院	xuéyuàn
*學者	xuézhě
*雪	xuě
雪白	xuěbái
雪花	xuěhuā
*血	xuè
*血管	xuèguǎn
*血液	xuèyè
尋	xún
尋求	xúnqiú
*尋找	xúnzhǎo
詢問	xúnwèn
*循環	xúnhuán
*迅速	xùnsù
訓	xùn
*訓練	xùnliàn
押	yā
鴉片	yāpiàn
鴨	yā
*壓	yā
*壓力	yālì
*壓迫	yāpò
壓縮	yāsuō
壓抑	yāyì
壓制	yāzhì
*牙	yá
牙齒	yáchǐ
*芽	yá
亞	yà
咽	yān
*煙	yān
煙囪	yān·cōng
*菸	yān
*延長	yáncháng
延伸	yánshēn
延續	yánxù
*言	yán
言論	yánlùn
*言語	yányŭ
岩	yán
*岩石	yánshí
*沿	yán
沿岸	yán'àn
*沿海	yánhǎi
炎	yán
*研究	yánjiū
研究生	yánjiūshēng
*研製	yánzhì
*顏色	yánsè
嚴	yán
*嚴格	yángé
嚴寒	yánhán
嚴峻	yánjùn
嚴厲	yánlì
嚴密	yánmì
*嚴肅	yánsù
*嚴重	yánzhòng
*鹽	yán
鹽酸	yánsuān
掩蓋	yǎngài
掩護	yǎnhù
*眼	yǎn
*眼光	yǎnguāng
*眼睛	yǎn·jing
眼鏡	yǎnjìng
眼看	yǎnkàn
*眼淚	yǎnlèi
*眼前	yǎnqián
眼神	yǎnshén
*演	yǎn
演變	yǎnbiàn
演唱	yǎnchàng
*演出	yǎnchū
演化	yǎnhuà
演講	yǎnjiǎng
演說	yǎnshuō
演繹	yǎnyì
*演員	yǎnyuán
*演奏	yǎnzòu
咽	yàn
宴會	yànhuì
厭	yàn
厭惡	yànwù
驗	yàn
驗證	yànzhèng
秧	yāng
*羊	yáng
羊毛	yángmáo
洋	yáng
揚	yáng
*陽	yáng
*陽光	yángguāng
*楊	yáng
仰	yǎng
*氧	yǎng
*氧化	yǎnghuà
*氧氣	yǎngqì
*養	yǎng
養分	yǎngfèn
養料	yǎngliào
養殖	yǎngzhí
*樣	yàng
樣本	yàngběn
樣式	yàngshì
*樣子	yàng·zi
*要	yāo
*要求	yāoqiú
*腰	yāo
*約	yāo
邀請	yāoqǐng
*搖	yáo
搖晃	yáo·huàng
搖頭	yáotóu
遙遠	yáoyuǎn
*咬	yǎo
*要	yào
要緊	yàojǐn
*要素	yàosù
*藥	yào
藥品	yàopǐn
*藥物	yàowù
鑰匙	yào·shi
耶穌	Yēsū
*爺爺	yé·ye
*也	yě
*也許	yěxŭ
冶金	yějīn
野	yě
野蠻	yěmán
野生	yěshēng
野獸	yěshòu
野外	yěwài
*夜	yè
夜間	yèjiān
*夜裏	yè·lǐ
*夜晚	yèwǎn
*液	yè
*液體	yètǐ
*頁	yè
*葉	yè
葉片	yèpiàn
*葉子	yè·zi
*業	yè
*業務	yèwù
業餘	yèyú
*一	yī
*一般	yībān
*一半	yībàn
一輩子	yībèi·zi
*一邊	yībiān
*一帶	yīdài
*一旦	yīdàn
*一定	yīdìng
一度	yīdù
一端	yīduān
一共	yīgòng
一貫	yīguàn
*一會兒	yīhuìr
一塊兒	yīkuàir
一連	yīlián
*一律	yīlǜ
*一面	yīmiàn
一旁	yīpáng
一齊	yīqí
*一起	yīqǐ
*一切	yīqiè
*一時	yīshí
一體	yītǐ
一同	yītóng
一線	yīxiàn
一向	yīxiàng
一心	yīxīn
一再	yīzài
一早	yīzǎo
*一直	yīzhí
*一致	yīzhì
*衣	yī
*衣服	yī·fu
衣裳	yī·shang
*依	yī
依次	yīcì
依法	yīfǎ
依附	yīfù
依舊	yījiù
*依據	yījù
*依靠	yīkào
*依賴	yīlài
*依然	yīrán
依照	yīzhào
醫	yī
醫療	yīliáo
*醫生	yīshēng
*醫學	yīxué
醫藥	yīyào
*醫院	yīyuàn
宜	yí
*移	yí
*移動	yídòng
移民	yímín
移植	yízhí
疑	yí
疑惑	yíhuò
疑問	yíwèn
儀	yí
*儀器	yíqì
*儀式	yíshì
遺	yí
遺產	yíchǎn
*遺傳	yíchuán
遺憾	yíhàn
遺留	yíliú
遺址	yízhǐ
遺囑	yízhŭ
*乙	yǐ
*已	yǐ
*已經	yǐ·jīng
*以	yǐ
*以便	yǐbiàn
*以後	yǐhòu
*以及	yǐjí
*以來	yǐlái
以免	yǐmiǎn
以內	yǐnèi
*以前	yǐqián
*以外	yǐwài
*以往	yǐwǎng
*以爲	yǐwéi
*以下	yǐxià
*以至	yǐzhì
*以致	yǐzhì
*矣	yǐ
倚	yǐ
椅子	yǐ·zi
蟻	yǐ
*亦	yì
*抑制	yìzhì
役	yì
*易	yì
易於	yìyú
益	yì
*異	yì
*異常	yìcháng
*意	yì
*意見	yì·jiàn
意境	yìjìng
*意識	yì·shí
*意思	yì·si
意圖	yìtú
*意外	yìwài
*意味	yìwèi
意象	yìxiàng
*意義	yìyì
*意志	yìzhì
*億	yì
*義	yì
*義務	yìwù
議	yì
*議會	yìhuì
*議論	yìlùn
議員	yìyuán
毅然	yìrán
翼	yì
藝	yì
*藝術	yìshù
*藝術家	yìshùjiā
譯	yì
*因	yīn
*因此	yīncǐ
因地制宜	yīndìzhìyí
*因而	yīn'ér
因果	yīnguŏ
*因素	yīnsù
*因爲	yīn·wèi
*音	yīn
音調	yīndiào
音階	yīnjiē
音節	yīnjié
音響	yīnxiǎng
*音樂	yīnyuè
*陰	yīn
陰謀	yīnmóu
陰陽	yīnyáng
陰影	yīnyǐng
*銀	yín
*銀行	yínháng
*引	yǐn
*引導	yǐndǎo
*引進	yǐnjìn
引力	yǐnlì
*引起	yǐnqǐ
引用	yǐnyòng
飲	yǐn
飲食	yǐnshí
隱	yǐn
隱蔽	yǐnbì
隱藏	yǐncáng
*印	yìn
印刷	yìnshuā
*印象	yìnxiàng
飲	yìn
*英	yīng
*英雄	yīngxióng
英勇	yīngyŏng
*嬰兒	yīng'ér
*應	yīng
*應當	yīngdāng
*應該	yīnggāi
鷹	yīng
迎	yíng
迎接	yíngjiē
盈利	yínglì
熒光屏	yíngguāngpíng
*營	yíng
*營養	yíngyǎng
營業	yíngyè
贏得	yíngdé
影	yǐng
影片	yǐngpiàn
*影響	yǐngxiǎng
*影子	yǐng·zi
映	yìng
*硬	yìng
*應	yìng
應付	yìng·fù
*應用	yìngyòng
擁	yōng
擁護	yōnghù
擁擠	yōngjǐ
*擁有	yōngyŏu
永	yŏng
永恆	yŏnghéng
永久	yŏngjiŭ
*永遠	yŏngyuǎn
*勇敢	yŏnggǎn
勇氣	yŏngqì
勇於	yŏngyú
涌	yŏng
涌現	yŏngxiàn
*用	yòng
用處	yòng·chù
用戶	yònghù
用力	yònglì
用品	yòngpǐn
用途	yòngtú
幽默	yōumò
悠久	yōujiŭ
憂鬱	yōuyù
優	yōu
*優點	yōudiǎn
優惠	yōuhuì
*優良	yōuliáng
*優美	yōuměi
*優勢	yōushì
優先	yōuxiān
*優秀	yōuxiù
優越	yōuyuè
優質	yōuzhì
尤	yóu
*尤其	yóuqí
尤爲	yóuwéi
*由	yóu
*由於	yóuyú
*油	yóu
油畫	yóuhuà
油田	yóutián
鈾	yóu
郵票	yóupiào
猶	yóu
猶如	yóurú
猶豫	yóuyù
*游	yóu
游泳	yóuyŏng
遊戲	yóuxì
遊行	yóuxíng
友	yŏu
友好	yŏuhǎo
友人	yŏurén
*友誼	yŏuyì
*有	yŏu
*有關	yŏuguān
*有機	yŏujī
*有力	yŏulì
*有利	yŏulì
有名	yŏumíng
*有趣	yŏuqù
有如	yŏurú
*有時	yŏushí
*有限	yŏuxiàn
*有效	yŏuxiào
有益	yŏuyì
有意	yŏuyì
*又	yòu
*右	yòu
右邊	yòu·biān
*右手	yòushŏu
*幼	yòu
幼兒	yòu'ér
幼苗	yòumiáo
幼年	yòunián
誘導	yòudǎo
予	yú
*於	yú
*於是	yúshì
娛樂	yúlè
*魚	yú
漁	yú
漁業	yúyè
*愉快	yúkuài
*餘	yú
餘地	yúdì
輿論	yúlùn
予	yŭ
*予以	yŭyǐ
羽	yŭ
羽毛	yŭmáo
*宇宙	yŭzhòu
*雨	yŭ
雨水	yŭshuǐ
*與	yŭ
與其	yŭqí
*語	yŭ
*語法	yŭfǎ
語句	yŭjù
語氣	yŭqì
語文	yŭwén
*語言	yŭyán
*語音	yŭyīn
玉	yù
*玉米	yùmǐ
*育	yù
*預報	yùbào
*預備	yùbèi
*預測	yùcè
預定	yùdìng
*預防	yùfáng
預計	yùjì
預料	yùliào
預期	yùqī
預算	yùsuàn
預先	yùxiān
預言	yùyán
域	yù
*欲	yù
慾望	yùwàng
遇	yù
遇見	yù·jiàn
*愈	yù
*元	yuán
*元素	yuánsù
*原	yuán
原材料	yuáncáiliào
*原來	yuánlái
*原理	yuánlǐ
原諒	yuánliàng
*原料	yuánliào
*原始	yuánshǐ
原先	yuánxiān
*原因	yuányīn
*原則	yuánzé
*原子	yuánzǐ
*源	yuán
*員	yuán
*圓	yuán
袁	Yuán
園	yuán
援助	yuánzhù
緣	yuán
*緣故	yuángù
*遠	yuǎn
遠方	yuǎnfāng
怨	yuàn
*院	yuàn
*院子	yuàn·zi
*願	yuàn
*願望	yuànwàng
*願意	yuànyì
*曰	yuē
*約	yuē
*約束	yuēshù
*月	yuè
月初	yuèchū
*月份	yuèfèn
月光	yuèguāng
*月亮	yuè·liang
*月球	yuèqiú
粵	yuè
*越	yuè
越過	yuèguò
*樂	yuè
樂隊	yuèduì
樂器	yuèqì
*樂曲	yuèqŭ
*閱讀	yuèdú
躍	yuè
勻	yún
*雲	yún
*允許	yŭnxŭ
*運	yùn
*運動	yùndòng
*運動員	yùndòngyuán
*運輸	yùnshū
運算	yùnsuàn
*運行	yùnxíng
*運用	yùnyòng
運轉	yùnzhuǎn
蘊藏	yùncáng
韻	yùn
紮	zā
砸	zá
雜	zá
雜誌	zázhì
雜質	zázhì
災難	zāinàn
栽	zāi
栽培	zāipéi
*再	zài
再見	zàijiàn
再現	zàixiàn
*在	zài
在場	zàichǎng
在家	zàijiā
*在於	zàiyú
*載	zài
*咱	zán
*咱們	zán·men
暫	zàn
*暫時	zànshí
贊成	zànchéng
讚美	zànměi
讚嘆	zàntàn
讚揚	zànyáng
髒	zāng
葬	zàng
*藏	zàng
臟	zàng
*遭	zāo
*遭受	zāoshòu
遭遇	zāoyù
糟	zāo
*早	zǎo
*早晨	zǎo·chén
*早期	zǎoqī
早日	zǎorì
早上	zǎo·shang
*早已	zǎoyǐ
藻	zǎo
竈	zào
*造	zào
造就	zàojiù
造型	zàoxíng
*則	zé
責	zé
*責任	zérèn
責任感	zérèngǎn
賊	zéi
怎	zěn
*怎麼	zěn·me
*怎麼樣	zěn·meyàng
*怎樣	zěnyàng
*曾	zēng
*增	zēng
*增產	zēngchǎn
*增多	zēngduō
增高	zēnggāo
*增加	zēngjiā
增進	zēngjìn
*增強	zēngqiáng
增添	zēngtiān
*增長	zēngzhǎng
紮	zhā
炸	zhá
眨	zhǎ
炸	zhà
炸彈	zhàdàn
摘	zhāi
窄	zhǎi
債	zhài
債務	zhàiwù
寨	zhài
*占	zhān
沾	zhān
粘	zhān
展	zhǎn
*展開	zhǎnkāi
展覽	zhǎnlǎn
展示	zhǎnshì
展現	zhǎnxiàn
盞	zhǎn
嶄新	zhǎnxīn
*佔	zhàn
佔據	zhànjù
*佔領	zhànlǐng
佔用	zhànyòng
*佔有	zhànyŏu
*站	zhàn
*戰	zhàn
*戰場	zhànchǎng
*戰鬥	zhàndòu
戰國	zhànguó
*戰略	zhànlüè
*戰勝	zhànshèng
*戰士	zhànshì
戰術	zhànshù
戰線	zhànxiàn
戰役	zhànyì
戰友	zhànyŏu
*戰爭	zhànzhēng
*張	zhāng
*章	zhāng
章程	zhāngchéng
*長	zhǎng
長官	zhǎngguān
掌	zhǎng
*掌握	zhǎngwò
漲	zhǎng
丈	zhàng
*丈夫	zhàng·fu
仗	zhàng
帳	zhàng
帳篷	zhàng·peng
脹	zhàng
賬	zhàng
漲	zhàng
*障礙	zhàng'ài
招	zhāo
招待	zhāodài
*招呼	zhāo·hu
招生	zhāoshēng
*着	zhāo
*朝	zhāo
*着	zháo
*着急	zháojí
*找	zhǎo
召集	zhàojí
*召開	zhàokāi
*照	zhào
*照顧	zhào·gù
照例	zhàolì
照明	zhàomíng
*照片	zhàopiàn
照射	zhàoshè
照相	zhàoxiàng
照相機	zhàoxiàngjī
照樣	zhàoyàng
照耀	zhàoyào
*趙	Zhào
遮	zhē
*折	zhé
折磨	zhé·mó
折射	zhéshè
*哲學	zhéxué
*者	zhě
*這	zhè
*這個	zhè·ge
*這裏	zhè·lǐ
*這麼	zhè·me
*這兒	zhèr
*這些	zhèxiē
*這樣	zhèyàng
珍貴	zhēnguì
珍珠	zhēnzhū
*真	zhēn
真誠	zhēnchéng
真空	zhēnkōng
*真理	zhēnlǐ
*真實	zhēnshí
*真正	zhēnzhèng
*針	zhēn
*針對	zhēnduì
鍼	zhēn
鍼灸	zhēnjiŭ
偵查	zhēnchá
偵察	zhēnchá
枕頭	zhěn·tou
*診斷	zhěnduàn
*振	zhèn
*振動	zhèndòng
振奮	zhènfèn
振興	zhènxīng
震	zhèn
震動	zhèndòng
震驚	zhènjīng
*陣	zhèn
*陣地	zhèndì
*鎮	zhèn
*鎮壓	zhènyā
征	zhēng
征服	zhēngfú
*爭	zhēng
爭奪	zhēngduó
*爭論	zhēnglùn
*爭取	zhēngqŭ
掙	zhēng
睜	zhēng
蒸	zhēng
*蒸發	zhēngfā
蒸氣	zhēngqì
徵求	zhēngqiú
徵收	zhēngshōu
*整	zhěng
*整頓	zhěngdùn
*整個	zhěnggè
*整理	zhěnglǐ
整齊	zhěngqí
*整體	zhěngtǐ
*正	zhèng
*正常	zhèngcháng
*正當	zhèngdāng
*正當	zhèngdàng
正規	zhèngguī
*正好	zhènghǎo
正面	zhèngmiàn
*正確	zhèngquè
*正式	zhèngshì
正義	zhèngyì
*正在	zhèngzài
政	zhèng
*政策	zhèngcè
*政黨	zhèngdǎng
*政府	zhèngfŭ
*政權	zhèngquán
*政治	zhèngzhì
*症	zhèng
*症狀	zhèngzhuàng
掙	zhèng
鄭	Zhèng
*證	zhèng
證據	zhèngjù
*證明	zhèngmíng
*證實	zhèngshí
證書	zhèngshū
*之	zhī
*之後	zhīhòu
*之前	zhīqián
*支	zhī
支部	zhībù
支撐	zhīchēng
*支持	zhīchí
*支出	zhīchū
支隊	zhīduì
支付	zhīfù
*支配	zhīpèi
*支援	zhīyuán
*枝	zhī
枝葉	zhīyè
肢	zhī
汁	zhī
*知	zhī
*知道	zhī·dào
知覺	zhījué
*知識	zhī·shi
脂肪	zhīfáng
*隻	zhī
織	zhī
*直	zhí
直角	zhíjiǎo
*直接	zhíjiē
*直徑	zhíjìng
直覺	zhíjué
直立	zhílì
直轄市	zhíxiáshì
*直線	zhíxiàn
直至	zhízhì
*值	zhí
*值得	zhí·dé
植	zhí
*植物	zhíwù
殖	zhí
殖民	zhímín
*殖民地	zhímíndì
*執行	zhíxíng
職	zhí
*職工	zhígōng
*職能	zhínéng
職權	zhíquán
*職務	zhíwù
*職業	zhíyè
職員	zhíyuán
職責	zhízé
止	zhǐ
*只	zhǐ
*只得	zhǐdé
只顧	zhǐgù
*只好	zhǐhǎo
*只是	zhǐshì
*只要	zhǐyào
*只有	zhǐyŏu
*指	zhǐ
*指標	zhǐbiāo
*指導	zhǐdǎo
指定	zhǐdìng
*指揮	zhǐhuī
指令	zhǐlìng
指明	zhǐmíng
指示	zhǐshì
指數	zhǐshù
指責	zhǐzé
*紙	zhǐ
至	zhì
至此	zhìcǐ
*至今	zhìjīn
*至少	zhìshǎo
*至於	zhìyú
*致	zhì
致富	zhìfù
致使	zhìshǐ
*志	zhì
*制	zhì
*制定	zhìdìng
*制訂	zhìdìng
*制度	zhìdù
*制約	zhìyuē
制止	zhìzhǐ
製品	zhìpǐn
*製造	zhìzào
*製作	zhìzuò
*治	zhì
治安	zhì'ān
治理	zhìlǐ
*治療	zhìliáo
*秩序	zhìxù
智	zhì
*智慧	zhìhuì
*智力	zhìlì
智能	zhìnéng
置	zhì
滯	zhì
*質	zhì
質變	zhìbiàn
*中	zhōng
中等	zhōngděng
中斷	zhōngduàn
中華	zhōnghuá
*中間	zhōngjiān
中年	zhōngnián
中期	zhōngqī
中世紀	zhōngshìjì
中樞	zhōngshū
中外	zhōngwài
中午	zhōngwŭ
*中心	zhōngxīn
中性	zhōngxìng
*中學	zhōngxué
中學生	zhōngxuéshēng
中旬	zhōngxún
*中央	zhōngyāng
中葉	zhōngyè
中醫	zhōngyī
中原	zhōngyuán
忠誠	zhōngchéng
忠實	zhōngshí
*終	zhōng
終究	zhōngjiū
終年	zhōngnián
終身	zhōngshēn
*終於	zhōngyú
*鐘	zhōng
鐘頭	zhōngtóu
腫	zhŏng
腫瘤	zhŏngliú
*種	zhŏng
*種類	zhŏnglèi
*種子	zhŏng·zi
種族	zhŏngzú
*中	zhòng
中毒	zhòngdú
*重	zhòng
*重大	zhòngdà
*重點	zhòngdiǎn
*重力	zhònglì
*重量	zhòngliàng
*重視	zhòngshì
*重要	zhòngyào
*種	zhòng
*種植	zhòngzhí
*衆	zhòng
*衆多	zhòngduō
衆人	zhòngrén
*州	zhōu
*周	zhōu
*周圍	zhōuwéi
周轉	zhōuzhuǎn
週年	zhōunián
*週期	zhōuqī
*軸	zhóu
晝夜	zhòuyè
皺	zhòu
朱	zhū
*株	zhū
珠	zhū
*諸	zhū
諸如	zhūrú
*豬	zhū
*竹	zhú
逐	zhú
*逐步	zhúbù
*逐漸	zhújiàn
逐年	zhúnián
*主	zhŭ
主編	zhŭbiān
*主持	zhŭchí
*主導	zhŭdǎo
*主動	zhŭdòng
*主觀	zhŭguān
主管	zhŭguǎn
主教	zhŭjiào
主力	zhŭlì
主權	zhŭquán
*主人	zhŭ·rén
主人公	zhŭréngōng
*主任	zhŭrèn
*主題	zhŭtí
*主體	zhŭtǐ
*主席	zhŭxí
*主要	zhŭyào
*主義	zhŭyì
*主意	zhŭ·yi(zhú·yi)
*主張	zhŭzhāng
煮	zhŭ
*屬	zhŭ
囑咐	zhŭ·fù
*住	zhù
住房	zhùfáng
住宅	zhùzhái
注	zhù
注射	zhùshè
注視	zhùshì
*注意	zhùyì
注重	zhùzhòng
*柱	zhù
*駐	zhù
助	zhù
助手	zhùshŏu
祝	zhù
祝賀	zhùhè
著	zhù
*著名	zhùmíng
*著作	zhùzuò
貯藏	zhùcáng
貯存	zhùcún
築	zhù
*抓	zhuā
抓緊	zhuājǐn
*專	zhuān
*專家	zhuānjiā
專利	zhuānlì
*專門	zhuānmén
專題	zhuāntí
*專業	zhuānyè
專用	zhuānyòng
*專政	zhuānzhèng
專制	zhuānzhì
磚	zhuān
*轉	zhuǎn
*轉變	zhuǎnbiàn
*轉動	zhuǎndòng
*轉化	zhuǎnhuà
*轉換	zhuǎnhuàn
*轉身	zhuǎnshēn
*轉向	zhuǎnxiàng
*轉移	zhuǎnyí
*傳	zhuàn
*轉	zhuàn
*轉動	zhuàndòng
*轉向	zhuànxiàng
賺	zhuàn
莊	zhuāng
莊稼	zhuāng·jia
莊嚴	zhuāngyán
*裝	zhuāng
裝備	zhuāngbèi
裝飾	zhuāngshì
*裝置	zhuāngzhì
樁	zhuāng
壯	zhuàng
壯大	zhuàngdà
*狀	zhuàng
*狀況	zhuàngkuàng
*狀態	zhuàngtài
撞	zhuàng
幢	zhuàng
*追	zhuī
追究	zhuījiū
*追求	zhuīqiú
追逐	zhuīzhú
*準	zhŭn
*準備	zhŭnbèi
*準確	zhŭnquè
準則	zhŭnzé
*捉	zhuō
桌	zhuō
*桌子	zhuō·zi
*着	zhuó
着手	zhuóshŏu
*着重	zhuózhòng
卓越	zhuóyuè
琢磨	zhuómó
咨詢	zīxún
姿勢	zīshì
*姿態	zītài
資	zī
*資本	zīběn
資產	zīchǎn
*資格	zī·gé
*資金	zījīn
*資料	zīliào
*資源	zīyuán
滋味	zīwèi
*子	zǐ
子彈	zǐdàn
子弟	zǐdì
子宮	zǐgōng
*子女	zǐnǚ
子孫	zǐsūn
*仔細	zǐxì
姊妹	zǐmèi
紫	zǐ
*自	zì
自稱	zìchēng
*自從	zìcóng
*自動	zìdòng
自動化	zìdònghuà
自發	zìfā
自豪	zìháo
*自己	zìjǐ
*自覺	zìjué
自力更生	zìlìgēngshēng
*自然	zìrán
*自然界	zìránjiè
自殺	zìshā
*自身	zìshēn
自衛	zìwèi
*自我	zìwŏ
自信	zìxìn
自行	zìxíng
自行車	zìxíngchē
*自由	zìyóu
自願	zìyuàn
自在	zìzài
自在	zì·zai
自治	zìzhì
*自治區	zìzhìqū
自主	zìzhŭ
自轉	zìzhuàn
*字	zì
字母	zìmŭ
宗	zōng
*宗教	zōngjiào
宗旨	zōngzhǐ
*綜合	zōnghé
*總	zŏng
總額	zŏng'é
總和	zŏnghé
*總結	zŏngjié
*總理	zŏnglǐ
總數	zŏngshù
總算	zŏngsuàn
*總體	zŏngtǐ
*總統	zŏngtŏng
*總之	zŏngzhī
縱	zòng
縱隊	zòngduì
*走	zŏu
走廊	zŏuláng
*走向	zŏuxiàng
奏	zòu
租	zū
租界	zūjiè
*足	zú
*足夠	zúgòu
足球	zúqiú
*足以	zúyǐ
*族	zú
阻	zŭ
*阻礙	zŭ'ài
阻力	zŭlì
阻止	zŭzhǐ
祖	zŭ
祖父	zŭfù
*祖國	zŭguó
祖母	zŭmŭ
*祖先	zŭxiān
祖宗	zŭ·zong
*組	zŭ
*組合	zŭhé
*組織	zŭzhī
*鑽	zuān
鑽研	zuānyán
*鑽	zuàn
*嘴	zuǐ
嘴巴	zuǐ·ba
*嘴脣	zuǐchún
*最	zuì
*最初	zuìchū
*最後	zuìhòu
*最近	zuìjìn
*最爲	zuìwéi
*最終	zuìzhōng
*罪	zuì
罪惡	zuì'è
罪犯	zuìfàn
罪行	zuìxíng
醉	zuì
尊	zūn
尊敬	zūnjìng
尊嚴	zūnyán
*尊重	zūnzhòng
*遵守	zūnshŏu
*遵循	zūnxún
*昨天	zuótiān
琢磨	zuó·mo
*左	zuŏ
左邊	zuŏ·biān
左手	zuŏshŏu
*左右	zuŏyòu
*作	zuò
作法	zuòfǎ
*作風	zuòfēng
*作家	zuòjiā
*作品	zuòpǐn
*作爲	zuòwéi
*作物	zuòwù
*作業	zuòyè
*作用	zuòyòng
*作戰	zuòzhàn
*作者	zuòzhě
*坐	zuò
*座	zuò
座位	zuòwèi
*做	zuò
*做法	zuòfǎ
做夢	zuòmèng
