哀	āi
哀愁	āichóu
哀傷	āishāng
哀怨	āiyuàn
捱	ái
癌	ái
*癌症	áizhèng
矮小	ǎixiǎo
艾	ài
愛不釋手	àibùshìshŏu
愛戴	àidài
愛理不理	àilǐbùlǐ
愛戀	àiliàn
愛侶	àilǚ
愛慕	àimù
*愛心	àixīn
曖昧	àimèi
礙	ài
礙於	àiyú
安頓	āndùn
安撫	ānfŭ
安魂曲	ānhúnqŭ
安居樂業	ānjūlèyè
*安老院	ānlǎoyuàn
安樂	ānlè
安理會	ānlǐhuì
安眠藥	ānmiányào
安寧	ānníng
安全帶	ānquándài
安全感	ānquángǎn
安然	ānrán
安穩	ānwĕn
安息	ānxī
安息日	Ānxīrì
安詳	ānxiáng
安享	ānxiǎng
安逸	ānyì
安葬	ānzàng
按部就班	ànbùjiùbān
按鍵	ànjiàn
*按揭	ànjiē
*按摩	ànmó
按鈕	ànniŭ
按時	ànshí
按壓	ànyā
*案例	ànlì
*案情	ànqíng
暗藏	àncáng
暗戀	ànliàn
暗室	ànshì
暗喻	ànyù
暗自	ànzì
黯	àn
黯然	ànrán
黯然失色	ànránshīsè
骯髒	āngzāng
昂	áng
*昂貴	ángguì
昂首	ángshŏu
盎然	àngrán
凹凸不平	āotūbùpíng
凹陷	āoxiàn
遨遊	áoyóu
熬製	áozhì
熬日子	áorì·zi
熬藥	áoyào
襖	ǎo
拗	ào
傲	ào
傲慢	àomàn
傲視	àoshì
奧	ào
奧妙	àomiào
*奧斯卡	Àosīkǎ
澳	ào
*八成	bāchéng
八哥兒	bāgēr
八卦	bāguà
八字	bāzì
*巴士	bāshì
芭比	Bābǐ
芭蕉	bājiāo
*芭蕾	bālĕi
*芭蕾舞	bālĕiwŭ
拔刀相助	bádāoxiāngzhù
拔河	báhé
拔尖兒	bájiānr
跋涉	báshè
把風	bǎfēng
把門	bǎmén
把玩	bǎwán
*罷了	bà·le
罷免	bàmiǎn
霸	bà
霸氣	bàqì
霸主	bàzhŭ
白癡	báichī
白瓷	báicí
白癲瘋	báidiānfēng
*白髮	báifà
白飯	báifàn
白費	báifèi
白果	báiguŏ
白話	báihuà
白話文	báihuàwén
*白酒	báijiŭ
白蘭地	báilándì
白領	báilǐng
白茫茫	báimángmáng
白描	báimiáo
白內障	báinèizhàng
白木耳	báimù'ěr
白皮書	báipíshū
白切雞	báiqiējī
白熱化	báirèhuà
白薯	báishŭ
白頭	báitóu
白血病	báixuèbìng
白血球	báixuèqiú
白字	báizì
百步穿楊	bǎibùchuānyáng
*百分比	bǎifēnbǐ
百廢待興	bǎifèidàixīng
百合	bǎihé
百花齊放	bǎihuāqífàng
百貨	bǎihuò
百聽不厭	bǎitīngbùyàn
百無聊賴	bǎiwúliáolài
柏	bǎi
柏油	bǎiyóu
*擺放	bǎifàng
擺架子	bǎijià·zi
擺設	bǎi·shè
拜祭	bàijì
拜師	bàishī
拜託	bàituō
*敗訴	bàisù
扳	bān
扳平	bānpíng
扳手	bānshŏu
*班次	bāncì
班底	bāndǐ
班級	bānjí
班長	bānzhǎng
斑	bān
斑駁	bānbó
斑點	bāndiǎn
斑馬	bānmǎ
斑馬線	bānmǎxiàn
斑痕	bānhén
斑斕	bānlán
斑紋	bānwén
頒	bān
頒發	bānfā
*頒獎	bānjiǎng
搬離	bānlí
搬遷	bānqiān
板擦	bǎncā
板書	bǎnshū
*版本	bǎnbĕn
版畫	bǎnhuà
*版權	bǎnquán
版圖	bǎntú
半邊	bànbiān
半價	bànjià
半空	bànkōng
半票	bànpiào
半日	bànrì
半身	bànshēn
半生	bànshēng
半死	bànsǐ
半途	bàntú
半信半疑	bànxìnbànyí
半子	bànzǐ
拌	bàn
絆	bàn
絆倒	bàndǎo
扮	bàn
*辦事處	bànshìchù
*辦學	bànxué
幫會	bānghuì
榜	bǎng
膀	bǎng
傍	bàng
磅	bàng
*棒球	bàngqiú
包藏	bāocáng
*包裹	bāoguŏ
包機	bāojī
包容	bāoróng
包銷	bāoxiāo
包紮	bāozā
包裝紙	bāozhuāngzhǐ
苞	bāo
胞	bāo
剝	bāo
雹	báo
薄餅	báobǐng
*保安	bǎo'ān
保安員	bǎo'ānyuán
保本	bǎobĕn
*保額	bǎo'é
*保單	bǎodān
*保費	bǎofèi
*保薦	bǎojiàn
保良局	bǎoliángjú
*保齡球	bǎolíngqiú
*保密	bǎomì
保暖	bǎonuǎn
保釋	bǎoshì
保稅	bǎoshuì
*保鮮	bǎoxiān
*保養	bǎoyǎng
保佑	bǎoyòu
*保育	bǎoyù
*保證金	bǎozhèngjīn
保值	bǎozhí
保質期	bǎozhìqī
堡	bǎo
*堡壘	bǎolĕi
飽覽	bǎolǎn
飽滿	bǎomǎn
飽暖	bǎonuǎn
飽受	bǎoshòu
飽學	bǎoxué
寶寶	bǎo·bǎo
寶玉	bǎoyù
寶藏	bǎozàng
寶座	bǎozuò
報案	bào'àn
報表	bàobiǎo
*報關	bàoguān
報館	bàoguǎn
*報價	bàojià
*報警	bàojǐng
報失	bàoshī
報時	bàoshí
報稅	bàoshuì
報攤	bàotān
報業	bàoyè
報應	bào·yìng
*報章	bàozhāng
抱歉	bàoqiàn
*鮑魚	bàoyú
豹	bào
暴	bào
暴斃	bàobì
暴風雨	bàofēngyŭ
暴利	bàolì
暴亂	bàoluàn
暴曬	bàoshài
暴躁	bàozào
曝光	bàoguāng
爆	bào
爆發力	bàofālì
爆裂	bàoliè
爆滿	bàomǎn
爆炸力	bàozhàlì
卑	bēi
卑賤	bēijiàn
卑劣	bēiliè
卑微	bēiwēi
碑	bēi
碑記	bēijì
碑林	bēilín
碑文	bēiwén
背負	bēifù
悲	bēi
悲觀	bēiguān
悲涼	bēiliáng
悲憫	bēimǐn
悲傷	bēishāng
悲天憫人	bēitiānmǐnrén
悲痛	bēitòng
悲喜	bēixǐ
悲壯	bēizhuàng
北邊	bĕibiān
北方人	bĕifāngrén
北風	bĕifēng
北極	Bĕijí
北極熊	bĕijíxióng
*貝殼	bèiké
背部	bèibù
背道而馳	bèidào'érchí
背脊	bèijǐ
背囊	bèináng
背誦	bèisòng
背向	bèixiàng
背影	bèiyǐng
被單	bèidān
*被迫	bèipò
被套	bèitào
被窩兒	bèiwōr
備案	bèi'àn
備份	bèifèn
備課	bèikè
*備忘錄	bèiwànglù
*備用	bèiyòng
*備戰	bèizhàn
備註	bèizhù
輩出	bèichū
奔波	bēnbō
奔放	bēnfàng
奔走	bēnzŏu
本部	bĕnbù
本分	bĕnfèn
*本金	bĕnjīn
*本科	bĕnkē
本利	bĕnlì
本票	bĕnpiào
*本土	bĕntŭ
本息	bĕnxī
本意	bĕnyì
本子	bĕn·zi
笨蛋	bèndàn
崩	bēng
崩塌	bēngtā
迸	bèng
迸發	bèngfā
泵	bèng
逼和	bīhé
逼真	bīzhēn
荸薺	bí·qí
鼻樑	bíliáng
鼻塞	bísè
鼻煙壺	bíyānhú
比比皆是	bǐbǐjiēshì
比對	bǐduì
比方	bǐ·fang
*比率	bǐlǜ
比美	bǐmĕi
比擬	bǐnǐ
比試	bǐshì
比照	bǐzhào
筆觸	bǐchù
筆調	bǐdiào
筆法	bǐfǎ
筆桿	bǐgǎn
筆畫	bǐhuà
筆記本	bǐjìbĕn
筆帽兒	bǐmàor
筆名	bǐmíng
筆墨	bǐmò
*筆下	bǐxià
鄙	bǐ
必備	bìbèi
必需品	bìxūpǐn
庇護	bìhù
庇佑	bìyòu
畢	bì
畢生	bìshēng
*畢業生	bìyèshēng
閉會	bìhuì
閉口	bìkŏu
*閉路電視	bìlùdiànshì
閉幕	bìmù
閉塞	bìsè
辟	bì
*壁虎	bìhŭ
避忌	bìjì
避難	bìnàn
避暑	bìshŭ
避重就輕	bìzhòngjiùqīng
裨益	bìyì
碧	bì
碧藍	bìlán
幣	bì
幣值	bìzhí
幣制	bìzhì
弊	bì
蔽	bì
斃	bì
斃命	bìmìng
編創	biānchuàng
編訂	biāndìng
*編號	biānhào
*編劇	biānjù
編碼	biānmǎ
編目	biānmù
*編排	biānpái
*編配	biānpèi
編曲	biānqŭ
編審	biānshĕn
*編舞	biānwŭ
編選	biānxuǎn
編印	biānyìn
編織	biānzhī
編著	biānzhù
編撰	biānzhuàn
編纂	biānzuǎn
蝙蝠	biānfú
邊陲	biānchuí
邊際	biānjì
鞭炮	biānpào
扁平	biǎnpíng
匾	biǎn
匾額	biǎn'é
貶	biǎn
貶值	biǎnzhí
便當	biàn·dang
便箋	biànjiān
便秘	biànmì
便服	biànfú
*便捷	biànjié
便裝	biànzhuāng
*遍佈	biànbù
遍地	biàndì
*遍及	biànjí
遍體鱗傷	biàntǐlínshāng
辨識	biànshí
辮	biàn
辮子	biàn·zi
辯	biàn
辯駁	biànbó
辯護人	biànhùrén
*辯論	biànlùn
辯題	biàntí
變本加厲	biànbĕnjiālì
變電站	biàndiànzhàn
變幻	biànhuàn
*變臉	biànliǎn
變賣	biànmài
變色	biànsè
變數	biànshù
變相	biànxiàng
變心	biànxīn
變奏	biànzòu
變量	biànliàng
標榜	biāobǎng
標點	biāodiǎn
*標記	biāojì
標價	biāojià
標明	biāomíng
標籤	biāoqiān
標示	biāoshì
標書	biāoshū
標貼	biāotiē
標誌	biāozhì
飆升	biāoshēng
表白	biǎobái
表弟	biǎodì
*表格	biǎogé
*表姐	biǎojiĕ
表決	biǎojué
表露	biǎolù
表妹	biǎomèi
表態	biǎotài
表兄	biǎoxiōng
別出心裁	biéchūxīncái
別號	biéhào
別具一格	biéjùyīgé
別開生面	biékāishēngmiàn
別離	biélí
別論	biélùn
別名	biémíng
*別墅	biéshù
別有用心	biéyŏuyòngxīn
別針	biézhēn
別致	bié·zhì
別字	biézì
彬彬有禮	bīnbīnyŏulǐ
賓客	bīnkè
賓至如歸	bīnzhìrúguī
濱	bīn
濱海	bīnhǎi
*繽紛	bīnfēn
瀕臨	bīnlín
瀕危	bīnwēi
殯殮	bìnliàn
殯儀館	bìnyíguǎn
冰雹	bīngbáo
冰凍	bīngdòng
冰棍兒	bīnggùnr
冰塊	bīngkuài
冰冷	bīnglĕng
冰涼	bīngliáng
冰山	bīngshān
冰糖	bīngtáng
冰箱	bīngxiāng
冰雪	bīngxuĕ
冰鎮	bīngzhèn
兵工廠	bīnggōngchǎng
兵馬俑	bīngmǎyŏng
兵器	bīngqì
兵團	bīngtuán
秉承	bǐngchéng
秉持	bǐngchí
屏息	bǐngxī
稟	bǐng
稟報	bǐngbào
稟賦	bǐngfù
餅乾	bǐnggān
並進	bìngjìn
*並列	bìngliè
並排	bìngpái
並行	bìngxíng
*並重	bìngzhòng
併發	bìngfā
*併發症	bìngfāzhèng
併入	bìngrù
摒棄	bìngqì
病患	bìnghuàn
病假	bìngjià
*病例	bìnglì
病歷	bìnglì
病逝	bìngshì
病態	bìngtài
病因	bìngyīn
病原體	bìngyuántǐ
病症	bìngzhèng
*波幅	bōfú
波及	bōjí
波濤	bōtāo
波折	bōzhé
菠蘿	bōluó
剝落	bōluò
砵	bō
般若	bōrĕ
撥款	bōkuǎn
撥冗	bōrŏng
播	bō
*播放	bōfàng
*播映	bōyìng
伯伯	bó·bo
伯父	bófù
泊	bó
*泊車	bóchē
箔	bó
帛	bó
脖	bó
博	bó
博愛	bó'ài
博大	bódà
博覽會	bólǎnhuì
博取	bóqŭ
博物館	bówùguǎn
博弈	bóyì
搏	bó
膊	bó
薄片	bópiàn
薄霧	bówù
駁	bó
駁斥	bóchì
駁回	bóhuí
薄荷	bò·he
卜	bŭ
哺乳	bŭrŭ
補給	bŭjǐ
補品	bŭpǐn
補習	bŭxí
補助	bŭzhù
不恥	bùchǐ
不辭勞苦	bùcíláokŭ
不單	bùdān
*不得	bùdé
不得而知	bùdé'érzhī
不動產	bùdòngchǎn
不對勁	bùduìjìn
不對頭	bùduìtóu
不乏	bùfá
不法	bùfǎ
不凡	bùfán
不菲	bùfěi
不忿	bùfèn
不服氣	bùfúqì
不符	bùfú
不甘	bùgān
不敢當	bùgǎndāng
不公	bùgōng
不軌	bùguǐ
不好受	bùhǎoshòu
不合時宜	bùhéshíyí
不懷好意	bùhuáihǎoyì
不悔	bùhuǐ
不惑	bùhuò
不羈	bùjī
不計其數	bùjìqíshù
不濟	bùjì
不假思索	bùjiǎsīsuŏ
不解之緣	bùjiĕzhīyuán
不經意	bùjīngyì
不拘	bùjū
不堪設想	bùkānshèxiǎng
*不可或缺	bùkĕhuòquē
不可思議	bùkĕsīyì
不勞而獲	bùláo'érhuò
不倫不類	bùlúnbùlèi
不落俗套	bùluòsútào
不謀而合	bùmóu'érhé
不耐煩	bùnàifán
不偏不倚	bùpiānbùyǐ
不切實際	bùqièshíjì
不屈	bùqū
不忍	bùrĕn
不容置疑	bùróngzhìyí
不善	bùshàn
不慎	bùshèn
不勝枚舉	bùshèngméijŭ
不識趣	bùshíqù
*不適	bùshì
不速之客	bùsùzhīkè
*不停	bùtíng
不同凡響	bùtóngfánxiǎng
不祥	bùxiáng
不像話	bùxiànghuà
不屑	bùxiè
不懈	bùxiè
不休	bùxiū
不鏽鋼	bùxiùgāng
不遜	bùxùn
不言而喻	bùyán'éryù
不夜城	bùyèchéng
不遺餘力	bùyíyúlì
不以為然	bùyǐwéirán
不翼而飛	bùyì'érfēi
不由自主	bùyóuzìzhŭ
不虞	bùyú
不約而同	bùyuē'értóng
不在乎	bùzài·hu
不折不扣	bùzhébùkòu
不爭	bùzhēng
*不知不覺	bùzhībùjué
不知所措	bùzhīsuŏcuò
不知所終	bùzhīsuŏzhōng
不只	bùzhǐ
不至於	bùzhìyú
不足為奇	bùzúwéiqí
布包	bùbāo
布料	bùliào
*佈景	bùjǐng
佈滿	bùmǎn
*步行	bùxíng
步行街	bùxíngjiē
部族	bùzú
簿	bù
擦肩而過	cājiān'érguò
猜拳	cāiquán
才華	cáihuá
才學	cáixué
才藝	cáiyì
才子	cáizǐ
財帛	cáibó
*財經	cáijīng
財神	cáishén
財團	cáituán
*財物	cáiwù
*財政司	cáizhèngsī
裁	cái
*裁定	cáidìng
裁斷	cáiduàn
裁剪	cáijiǎn
裁減	cáijiǎn
裁員	cáiyuán
彩燈	cǎidēng
*彩虹	cǎihóng
彩票	cǎipiào
彩雲	cǎiyún
採礦	cǎikuàng
*採納	cǎinà
採擷	cǎixié
採摘	cǎizhāi
綵帶	cǎidài
菜單兒	càidānr
菜刀	càidāo
*菜館	càiguǎn
菜譜	càipŭ
*菜肴	càiyáo
參拜	cānbài
參建	cānjiàn
參考書	cānkǎoshū
*參賽	cānsài
參天	cāntiān
參選	cānxuǎn
參演	cānyǎn
參議員	cānyìyuán
*參閱	cānyuè
*參展	cānzhǎn
餐	cān
餐點	cāndiǎn
*餐館	cānguǎn
餐巾	cānjīn
餐具	cānjù
餐廳	cāntīng
*餐飲	cānyǐn
*餐桌	cānzhuō
殘廢	cánfèi
*殘疾	cánjí
殘舊	cánjiù
殘局	cánjú
殘留	cánliú
殘破	cánpò
殘缺	cánquē
殘殺	cánshā
殘渣	cánzhā
殘障	cánzhàng
慘	cǎn
慘白	cǎnbái
慘澹	cǎndàn
慘劇	cǎnjù
慘況	cǎnkuàng
慘烈	cǎnliè
慘痛	cǎntòng
慘重	cǎnzhòng
倉卒	cāngcù
滄海	cānghǎi
滄桑	cāngsāng
蒼	cāng
蒼翠	cāngcuì
蒼勁	cāngjìng
蒼老	cānglǎo
蒼涼	cāngliáng
蒼茫	cāngmáng
蒼穹	cāngqióng
蒼生	cāngshēng
藏匿	cángnì
藏品	cángpǐn
操場	cāochǎng
*操控	cāokòng
*操守	cāoshŏu
操之過急	cāozhīguòjí
糙	cāo
糙米	cāomǐ
嘈雜	cáozá
草場	cǎochǎng
草創	cǎochuàng
草稿	cǎogǎo
草根	cǎogēn
草莓	cǎoméi
草木	cǎomù
*草擬	cǎonǐ
草皮	cǎopí
草坪	cǎopíng
草書	cǎoshū
草圖	cǎotú
草藥	cǎoyào
冊封	cèfēng
側目	cèmù
惻隱	cèyǐn
測繪	cèhuì
策	cè
策動	cèdòng
參差	cēncī
層出不窮	céngchūbùqióng
*層面	céngmiàn
叉燒	chāshāo
差池	chāchí
差額	chā'é
插花	chāhuā
插曲	chāqŭ
插手	chāshŏu
插圖	chātú
插座	chāzuò
茶杯	chábēi
茶餐廳	chácāntīng
茶道	chádào
茶點	chádiǎn
茶壺	cháhú
茶會	cháhuì
茶几	chájī
*茶具	chájù
茶樓	chálóu
茶藝	cháyì
茶園	cháyuán
茶莊	cházhuāng
查核	cháhé
查看	chákàn
查問	cháwèn
*查詢	cháxún
查驗	cháyàn
*查閱	cháyuè
查證	cházhèng
察覺	chájué
察看	chákàn
岔	chà
剎	chà
剎那	chànà
差勁	chàjìn
拆除	chāichú
拆穿	chāichuān
拆毀	chāihuǐ
拆夥	chāihuŏ
拆解	chāijiĕ
拆散	chāisàn
*拆卸	chāixiè
差役	chāiyì
攙	chān
攙扶	chānfú
孱弱	chánruò
嬋娟	chánjuān
禪	chán
禪宗	chánzōng
蟬	chán
蟬聯	chánlián
蟬聲	chánshēng
纏結	chánjié
纏綿	chánmián
纏繞	chánrào
饞	chán
饞嘴	chánzuǐ
*產假	chǎnjià
產區	chǎnqū
產權	chǎnquán
鏟	chǎn
鏟除	chǎnchú
闡釋	chǎnshì
懺悔	chànhuǐ
顫	chàn
顫動	chàndòng
昌	chāng
昌隆	chānglóng
昌明	chāngmíng
昌盛	chāngshèng
猖獗	chāngjué
*長達	chángdá
長笛	chángdí
長方形	chángfāngxíng
長頸鹿	chángjǐnglù
*長廊	chángláng
長袍	chángpáo
長生不老	chángshēngbùlǎo
長途	chángtú
*長線	chángxiàn
長足	chángzú
常理	chánglǐ
*常任	chángrèn
常態	chángtài
*常務	chángwù
常駐	chángzhù
償	cháng
償付	chángfù
*償還	chánghuán
償債	chángzhài
徜徉	chángyáng
場次	chǎngcì
場館	chǎngguǎn
場景	chǎngjǐng
*廠商	chǎngshāng
倡	chàng
*倡議	chàngyì
*唱歌	chànggē
唱功	chànggōng
唱好	chànghǎo
唱機	chàngjī
唱片	chàngpiàn
唱腔	chàngqiāng
唱曲	chàngqŭ
暢	chàng
暢快	chàngkuài
暢所欲言	chàngsuŏyùyán
暢通	chàngtōng
*暢旺	chàngwàng
*暢遊	chàngyóu
抄錄	chāolù
抄襲	chāoxí
鈔	chāo
*鈔票	chāopiào
超車	chāochē
超短裙	chāoduǎnqún
*超級	chāojí
超前	chāoqián
超然	chāorán
超人	chāorén
超時	chāoshí
超脫	chāotuō
超支	chāozhī
超值	chāozhí
超重	chāozhòng
超卓	chāozhuó
巢	cháo
巢穴	cháoxué
朝聖	cháoshèng
嘲諷	cháofĕng
潮水	cháoshuǐ
潮汐	cháoxī
*吵架	chǎojià
吵鬧	chǎonào
炒菜	chǎocài
炒飯	chǎofàn
炒家	chǎojiā
炒賣	chǎomài
炒麵	chǎomiàn
炒作	chǎozuò
*車廠	chēchǎng
*車程	chēchéng
車道	chēdào
車隊	chēduì
*車費	chēfèi
*車禍	chēhuò
車庫	chēkù
車齡	chēlíng
車流	chēliú
車門	chēmén
車牌	chēpái
車票	chēpiào
*車身	chēshēn
車水馬龍	chēshuǐmǎlóng
*車速	chēsù
車胎	chētāi
車頭	chētóu
車尾	chēwĕi
車位	chēwèi
掣	chè
掣肘	chèzhŏu
徹	chè
徹查	chèchá
徹頭徹尾	chètóuchèwĕi
徹夜	chèyè
撤離	chèlí
撤職	chèzhí
澈	chè
沉厚	chénhòu
沉寂	chénjì
沉淪	chénlún
沉迷	chénmí
沉默寡言	chénmòguǎyán
沉沒	chénmò
沉溺	chénnì
沉睡	chénshuì
沉鬱	chényù
沉醉	chénzuì
辰	chén
晨	chén
*晨曦	chénxī
*陳列	chénliè
陳年	chénnián
陳皮	chénpí
陳設	chénshè
*塵埃	chén'āi
塵封	chénfēng
塵世	chénshì
趁便	chènbiàn
趁熱	chènrè
趁勢	chènshì
襯	chèn
襯衫	chènshān
襯托	chèntuō
稱職	chènzhí
稱頌	chēngsòng
稱謂	chēngwèi
稱許	chēngxŭ
稱譽	chēngyù
丞	chéng
丞相	chéngxiàng
成敗	chéngbài
*成交	chéngjiāo
成名	chéngmíng
*成年人	chéngniánrén
成千上萬	chéngqiānshàngwàn
成行	chéngxíng
*成衣	chéngyī
*成因	chéngyīn
*成員國	chéngyuánguó
*城堡	chéngbǎo
*城門	chéngmén
*城牆	chéngqiáng
城鄉	chéngxiāng
城寨	chéngzhài
誠然	chéngrán
誠如	chéngrú
*誠信	chéngxìn
*誠意	chéngyì
*呈報	chéngbào
*呈交	chéngjiāo
*呈請	chéngqǐng
呈獻	chéngxiàn
*承辦	chéngbàn
承保	chéngbǎo
承兌	chéngduì
承繼	chéngjì
承接	chéngjiē
*承諾	chéngnuò
承襲	chéngxí
承運	chéngyùn
承載	chéngzài
承轉	chéngzhuǎn
乘車證	chéngchēzhèng
乘船	chéngchuán
乘客	chéngkè
乘涼	chéngliáng
乘勢	chéngshì
乘虛而入	chéngxū'érrù
*乘坐	chéngzuò
橙	chéng
橙汁	chéngzhī
懲	chéng
懲處	chéngchŭ
吃不消	chī·bùxiāo
吃醋	chīcù
吃虧	chīkuī
吃喝兒	chīhēr
吃香	chīxiāng
馳騁	chíchĕng
馳名	chímíng
*持平	chípíng
持之以恆	chízhīyǐhéng
匙	chí
踟躕	chíchú
遲到	chídào
遲鈍	chídùn
遲緩	chíhuǎn
遲早	chízǎo
尺碼	chǐmǎ
尺子	chǐ·zi
*呎	chǐ
恥笑	chǐxiào
豉	chǐ
斥	chì
斥責	chìzé
*斥資	chìzī
叱咤	chìzhà
赤腳	chìjiǎo
赤裸	chìluŏ
赤字	chìzì
熾烈	chìliè
熾熱	chìrè
充斥	chōngchì
充電	chōngdiàn
充公	chōnggōng
充飢	chōngjī
充沛	chōngpèi
*充裕	chōngyù
沖	chōng
沖淡	chōngdàn
沖積	chōngjī
沖浪	chōnglàng
沖泡	chōngpào
沖洗	chōngxǐ
衝刺	chōngcì
*憧憬	chōngjǐng
*重播	chóngbō
重蹈覆轍	chóngdǎofùzhé
重讀	chóngdú
*重返	chóngfǎn
重逢	chóngféng
重光	chóngguāng
*重建	chóngjiàn
*重申	chóngshēn
重生	chóngshēng
*重溫	chóngwēn
*重現	chóngxiàn
*重修	chóngxiū
重演	chóngyǎn
重陽節	Chóngyángjié
重振	chóngzhèn
*重整	chóngzhĕng
重奏	chóngzòu
*重組	chóngzŭ
崇尚	chóngshàng
蟲牙	chóngyá
寵	chŏng
寵愛	chŏng'ài
*寵物	chŏngwù
抽查	chōuchá
抽搐	chōuchù
抽筋	chōujīn
抽空	chōukòng
抽籤	chōuqiān
抽取	chōuqŭ
抽驗	chōuyàn
抽樣	chōuyàng
仇	chóu
仇人	chóurén
仇怨	chóuyuàn
惆悵	chóuchàng
稠	chóu
稠密	chóumì
綢	chóu
酬金	chóujīn
酬勞	chóuláo
籌	chóu
*籌辦	chóubàn
*籌備	chóubèi
籌措	chóucuò
*籌劃	chóuhuà
籌集	chóují
籌款	chóukuǎn
籌碼	chóumǎ
籌募	chóumù
籌資	chóuzī
醜八怪	chŏubāguài
醜陋	chŏulòu
醜聞	chŏuwén
臭蟲	chòuchóng
臭烘烘	chòuhōnghōng
臭氧	chòuyǎng
*出版社	chūbǎnshè
出醜	chūchŏu
出處	chūchù
*出錯	chūcuò
出道	chūdào
出軌	chūguǐ
出航	chūháng
*出擊	chūjī
出嫁	chūjià
*出口商	chūkŏushāng
出類拔萃	chūlèibácuì
出籠	chūlóng
出爐	chūlú
出毛病	chūmáo·bìng
出沒	chūmò
出謀獻策	chūmóuxiàncè
*出品	chūpǐn
出其不意	chūqíbùyì
出奇	chūqí
出勤	chūqín
出人意料	chūrényìliào
*出任	chūrèn
*出入	chūrù
*出入境	chūrùjìng
*出入口	chūrùkŏu
出賽	chūsài
出神	chūshén
出神入化	chūshénrùhuà
出生地	chūshēngdì
出生率	chūshēnglǜ
出使	chūshǐ
*出示	chūshì
*出世	chūshì
*出台	chūtái
出庭	chūtíng
*出頭	chūtóu
出外	chūwài
出線	chūxiàn
出行	chūxíng
出巡	chūxún
出征	chūzhēng
出資	chūzī
*出租	chūzū
初版	chūbǎn
初春	chūchūn
初冬	chūdōng
初戀	chūliàn
初秋	chūqiū
初賽	chūsài
初夏	chūxià
初夜	chūyè
*除外	chúwài
除夕	chúxī
廚	chú
廚具	chújù
*廚師	chúshī
廚藝	chúyì
櫥	chú
櫥窗	chúchuāng
雛	chú
雛形	chúxíng
儲	chŭ
儲藏	chŭcáng
處變不驚	chŭbiànbùjīng
*處方	chŭfāng
*處理器	chŭlǐqì
處世	chŭshì
處心積慮	chŭxīnjīlǜ
*處置	chŭzhì
*處所	chùsuŏ
觸電	chùdiàn
觸動	chùdòng
觸發	chùfā
*觸犯	chùfàn
觸及	chùjí
*觸覺	chùjué
*觸摸	chùmō
觸目驚心	chùmùjīngxīn
矗立	chùlì
揣	chuāi
揣測	chuǎicè
揣摩	chuǎimó
川流不息	chuānliúbùxī
穿插	chuānchā
穿戴	chuāndài
*穿梭	chuānsuō
穿行	chuānxíng
穿針引線	chuānzhēnyǐnxiàn
船廠	chuánchǎng
船塢	chuánwù
船員	chuányuán
傳承	chuánchéng
傳道	chuándào
傳教	chuánjiào
*傳媒	chuánméi
*傳票	chuánpiào
*傳奇	chuánqí
傳球	chuánqiú
*傳染	chuánrǎn
傳熱	chuánrè
傳神	chuánshén
傳輸	chuánshū
*傳送	chuánsòng
傳頌	chuánsòng
傳聞	chuánwén
傳銷	chuánxiāo
*傳訊	chuánxùn
傳言	chuányán
傳揚	chuányáng
傳譯	chuányì
傳閱	chuányuè
*傳真	chuánzhēn
喘氣	chuǎnqì
喘息	chuǎnxī
窗花	chuānghuā
窗框	chuāngkuàng
瘡	chuāng
瘡痍	chuāngyí
床單	chuángdān
床頭	chuángtóu
闖蕩	chuǎngdàng
創刊	chuàngkān
*創建	chuàngjiàn
創舉	chuàngjŭ
創設	chuàngshè
創始	chuàngshǐ
創校	chuàngxiào
*創業	chuàngyè
*創意	chuàngyì
創制	chuàngzhì
吹拂	chuīfú
吹噓	chuīxū
吹奏	chuīzòu
炊具	chuījù
垂釣	chuídiào
垂老	chuílǎo
垂淚	chuílèi
垂青	chuíqīng
垂死	chuísǐ
垂涎	chuíxián
垂涎欲滴	chuíxiányùdī
春暉	chūnhuī
春卷	chūnjuǎn
春聯	chūnlián
春夢	chūnmèng
春日	chūnrì
春色	chūnsè
春雨	chūnyŭ
純淨	chúnjìng
*純利	chúnlì
純樸	chúnpŭ
純情	chúnqíng
純熟	chúnshú
純真	chúnzhēn
純正	chúnzhèng
淳厚	chúnhòu
淳樸	chúnpŭ
醇	chún
蠢	chŭn
蠢蠢欲動	chŭnchŭnyùdòng
戳	chuō
戳破	chuōpò
綽綽有餘	chuòchuòyŏuyú
綽號	chuòhào
輟學	chuòxué
祠	cí
*祠堂	cítáng
詞人	círén
*詞彙	cíhuì
瓷	cí
瓷瓶	cípíng
瓷器	cíqì
慈	cí
慈悲	cíbēi
慈母	címŭ
*慈善	císhàn
磁片	cípiàn
磁器	cíqì
磁性	cíxìng
雌性	cíxìng
辭呈	cíchéng
辭藻	cízǎo
此起彼伏	cǐqǐbǐfú
次貨	cìhuò
次品	cìpǐn
刺耳	cì'ĕr
刺骨	cìgŭ
刺殺	cìshā
刺眼	cìyǎn
匆忙	cōngmáng
蔥	cōng
聰慧	cōnghuì
聰穎	cōngyǐng
從教	cóngjiào
從容	cóngróng
從善如流	cóngshànrúliú
從商	cóngshāng
從速	cóngsù
從天而降	cóngtiān'érjiàng
*從未	cóngwèi
*從業	cóngyè
從政	cóngzhèng
叢林	cónglín
叢生	cóngshēng
湊合	còu·he
湊錢	còuqián
湊熱鬧	còurè·nào
粗鄙	cūbǐ
粗獷	cūguǎng
粗豪	cūháo
粗話	cūhuà
粗略	cūlüè
粗俗	cūsú
粗言穢語	cūyánhuìyŭ
粗枝大葉	cūzhīdàyè
粗壯	cūzhuàng
*促請	cùqǐng
促銷	cùxiāo
猝然	cùrán
猝死	cùsǐ
醋	cù
簇新	cùxīn
簇擁	cùyōng
汆	cuān
篡位	cuànwèi
催促	cuīcù
催化	cuīhuà
催化劑	cuīhuàjì
催淚	cuīlèi
催眠	cuīmián
摧	cuī
*璀璨	cuǐcàn
脆	cuì
脆嫩	cuìnèn
翠	cuì
*村落	cūnluò
*村民	cūnmín
村長	cūnzhǎng
存單	cúndān
*存檔	cúndàng
*存放	cúnfàng
*存戶	cúnhù
存貨	cúnhuò
存量	cúnliàng
存取	cúnqŭ
存心	cúnxīn
存摺	cúnzhé
寸草不生	cùncǎobùshēng
吋	cùn
搓	cuō
搓揉	cuōróu
*磋商	cuōshāng
挫	cuò
挫敗	cuòbài
措手不及	cuòshŏubùjí
錯怪	cuòguài
*錯過	cuòguò
錯覺	cuòjué
錯漏	cuòlòu
錯亂	cuòluàn
錯失	cuòshī
錯綜複雜	cuòzōngfùzá
搭夥	dāhuŏ
搭建	dājiàn
*搭配	dāpèi
答允	dāyŭn
*達標	dábiāo
*答辯	dábiàn
答題	dátí
答謝	dáxiè
打岔	dǎchà
打從	dǎcóng
打道	dǎdào
打點	dǎ·dian
打賭	dǎdŭ
打斷	dǎduàn
打哆嗦	dǎduō·suo
打發	dǎ·fa
打工	dǎgōng
打呼嚕	dǎhū·lu
打火機	dǎhuŏjī
打攪	dǎjiǎo
打劫	dǎjié
打撈	dǎlāo
打理	dǎlǐ
打獵	dǎliè
打氣	dǎqì
打趣	dǎqù
*打造	dǎzào
打折	dǎzhé
打針	dǎzhēn
打樁	dǎzhuāng
大巴	dàbā
大壩	dàbà
大班	dàbān
大飽口福	dàbǎokŏufú
大不了	dà·bùliǎo
大吃一驚	dàchīyījīng
大刀闊斧	dàdāokuòfŭ
*大道	dàdào
大動脈	dàdòngmài
大發雷霆	dàfāléitíng
大放異彩	dàfàngyìcǎi
*大佛	dàfó
大功告成	dàgōnggàochéng
大公無私	dàgōngwúsī
大汗淋漓	dàhànlínlí
大會堂	dàhuìtáng
大聲	dàshēng
大亨	dàhēng
大街小巷	dàjiēxiǎoxiàng
大驚小怪	dàjīngxiǎoguài
大開眼界	dàkāiyǎnjiè
*大快朵頤	dàkuàiduŏyí
大力	dàlì
*大樓	dàlóu
大略	dàlüè
大麻	dàmá
大難不死	dànànbùsǐ
大排檔	dàpáidàng
大牌	dàpái
大氣層	dàqìcéng
*大賽	dàsài
大掃除	dàsǎochú
*大廈	dàshà
大嬸	dàshĕn
*大使	dàshǐ
*大市	dàshì
大勢	dàshì
大蒜	dàsuàn
*大堂	dàtáng
大提琴	dàtíqín
大同小異	dàtóngxiǎoyì
大腿	dàtuǐ
大顯身手	dàxiǎnshēnshŏu
大相徑庭	dàxiāngjìngtíng
大興土木	dàxīngtŭmù
大行其道	dàxíngqídào
大專	dàzhuān
呆滯	dāizhì
逮	dǎi
代表處	dàibiǎochù
代表作	dàibiǎozuò
代課	dàikè
代勞	dàiláo
代替品	dàitìpǐn
代言人	dàiyánrén
逮	dài
貸	dài
袋鼠	dàishŭ
*帶子	dài·zi
丹	dān
單薄	dānbó
*單程	dānchéng
單軌	dānguǐ
*單據	dānjù
單親	dānqīn
單身	dānshēn
單身漢	dānshēnhàn
單行線	dānxíngxiàn
*單元	dānyuán
*擔保	dānbǎo
*擔當	dāndāng
*擔憂	dānyōu
*膽固醇	dǎngùchún
膽識	dǎnshí
膽子	dǎn·zi
旦	dàn
淡薄	dànbó
淡化	dànhuà
淡然	dànrán
淡色	dànsè
淡市	dànshì
淡水魚	dànshuǐyú
淡忘	dànwàng
淡雅	dànyǎ
*蛋黃	dànhuáng
誕	dàn
彈殼	dànké
彈頭	dàntóu
彈丸之地	dànwánzhīdì
彈藥	dànyào
當日	dāngrì
當務之急	dāngwùzhījí
當下	dāngxià
當之無愧	dāngzhīwúkuì
黨魁	dǎngkuí
當日	dàngrì
檔	dàng
檔位	dàngwèi
蕩	dàng
蕩氣回腸	dàngqìhuícháng
蕩然無存	dàngránwúcún
蕩漾	dàngyàng
刀鋒	dāofēng
刀架	dāojià
刀具	dāojù
倒閉	dǎobì
倒戈	dǎogē
倒塌	dǎotā
倒胃口	dǎowèi·kou
搗	dǎo
搗蛋	dǎodàn
搗亂	dǎoluàn
搗碎	dǎosuì
導讀	dǎodú
*導師	dǎoshī
*導向	dǎoxiàng
導言	dǎoyán
導引	dǎoyǐn
*導遊	dǎoyóu
禱告	dǎogào
禱文	dǎowén
蹈	dǎo
*到場	dàochǎng
*到訪	dàofǎng
到位	dàowèi
倒背如流	dàobèirúliú
倒掛	dàoguà
倒流	dàoliú
倒數	dàoshŭ
倒數	dàoshù
倒影	dàoyǐng
道觀	dàoguàn
道家	Dàojiā
道具	dàojù
道路網	dàolùwǎng
道袍	dàopáo
道士	dào·shi
道謝	dàoxiè
道義	dàoyì
盜	dào
*盜版	dàobǎn
盜用	dàoyòng
盜賊	dàozéi
稻米	dàomǐ
得不償失	débùchángshī
得分	défēn
得失	déshī
得手	déshŏu
得體	détǐ
得天獨厚	détiāndúhòu
*得悉	déxī
得心應手	déxīnyìngshŏu
*得宜	déyí
*得益	déyì
得意忘形	déyìwàngxíng
*得主	dézhŭ
德行	déxíng
登場	dēngcháng
登場	dēngchǎng
登車	dēngchē
登高	dēnggāo
登記	dēngjì
登記冊	dēngjìcè
*登記處	dēngjìchù
登錄	dēnglù
登山	dēngshān
燈籠	dēng·long
燈飾	dēngshì
*燈塔	dēngtǎ
燈箱	dēngxiāng
燈影	dēngyǐng
等額	dĕng'é
等號	dĕnghào
等價	dĕngjià
等離子	dĕnglízǐ
*等同	dĕngtóng
等閒	dĕngxián
等值	dĕngzhí
凳	dèng
低潮	dīcháo
低沉	dīchén
低調	dīdiào
低估	dīgū
*低廉	dīlián
低落	dīluò
低迷	dīmí
低窪	dīwā
低音	dīyīn
提防	dī·fang
嘀咕	dí·gu
滴水	dīshuǐ
迪士尼	Díshìní
笛	dí
*的士	díshì
敵軍	díjūn
敵意	díyì
底部	dǐbù
底價	dǐjià
底盤	dǐpán
底片	dǐpiàn
底線	dǐxiàn
底薪	dǐxīn
底蘊	dǐyùn
抵觸	dǐchù
*抵達	dǐdá
抵擋	dǐdǎng
抵賴	dǐlài
*抵銷	dǐxiāo
*抵押	dǐyā
抵禦	dǐyù
詆毀	dǐhuǐ
*地標	dìbiāo
*地產	dìchǎn
*地道	dìdào
*地道	dì·dao
地動山搖	dìdòngshānyáo
*地段	dìduàn
地基	dìjī
*地價	dìjià
地名	dìmíng
*地盤	dìpán
*地皮	dìpí
地平線	dìpíngxiàn
地契	dìqì
地勤	dìqín
地毯	dìtǎn
*地鐵	dìtiĕ
*地鐵站	dìtiĕzhàn
地下室	dìxiàshì
*地獄	dìyù
地氈	dìzhān
*地政	dìzhèng
地支	dìzhī
地址	dìzhǐ
弟婦	dìfù
*第三者	dìsānzhĕ
締	dì
締約	dìyuē
*締造	dìzào
*遞交	dìjiāo
顛	diān
顛沛流離	diānpèiliúlí
巔	diān
巔峰	diānfēng
典當	diǎndàng
典範	diǎnfàn
典故	diǎngù
典籍	diǎnjí
*典禮	diǎnlǐ
典雅	diǎnyǎ
點滴	diǎndī
點擊	diǎnjī
點球	diǎnqiú
點數	diǎnshù
點題	diǎntí
點心	diǎn·xin
*點綴	diǎnzhuì
店面	diànmiàn
*店鋪	diànpù
店主	diànzhŭ
奠	diàn
殿	diàn
殿堂	diàntáng
電波	diànbō
電廠	diànchǎng
電車	diànchē
電磁爐	diàncílú
電費	diànfèi
電話線	diànhuàxiàn
電匯	diànhuì
*電纜	diànlǎn
電鈴	diànlíng
*電腦化	diànnǎohuà
電氣	diànqì
電氣化	diànqìhuà
電梯	diàntī
電筒	diàntŏng
電網	diànwǎng
*電信	diànxìn
*電訊	diànxùn
*電影節	diànyǐngjié
*電影院	diànyǐngyuàn
電子琴	diànzǐqín
靛	diàn
凋零	diāolíng
凋謝	diāoxiè
碉堡	diāobǎo
雕飾	diāoshì
雕塑家	diāosùjiā
*雕像	diāoxiàng
雕琢	diāozhuó
吊車	diàochē
吊燈	diàodēng
吊橋	diàoqiáo
吊銷	diàoxiāo
掉以輕心	diàoyǐqīngxīn
釣	diào
*釣魚	diàoyú
調派	diàopài
調任	diàorèn
調頭	diàotóu
調研	diàoyán
調子	diào·zi
跌宕	diēdàng
跌倒	diēdǎo
*跌幅	diēfú
跌落	diēluò
跌勢	diēshì
蝶	dié
*碟	dié
疊	dié
*丁屋	dīngwū
叮	dīng
叮噹	dīngdāng
頂峰	dǐngfēng
頂呱呱	dǐngguāguā
*頂級	dǐngjí
頂樓	dǐnglóu
鼎	dǐng
鼎鼎大名	dǐngdǐngdàmíng
鼎力	dǐnglì
鼎盛	dǐngshèng
定奪	dìngduó
*定價	dìngjià
*定居	dìngjū
定論	dìnglùn
定神	dìngshén
*定時	dìngshí
*定位	dìngwèi
*定罪	dìngzuì
訂單	dìngdān
*訂購	dìnggòu
訂戶	dìnghù
訂價	dìngjià
*訂金	dìngjīn
*訂立	dìnglì
*訂造	dìngzào
丟臉	diūliǎn
丟人	diūrén
冬瓜	dōngguā
冬至	dōngzhì
東風	dōngfēng
東拉西扯	dōnglāxīchĕ
董	dŏng
*董事	dŏngshì
*董事會	dŏngshìhuì
*董事局	dŏngshìjú
*董事長	dŏngshìzhǎng
洞察	dòngchá
洞窟	dòngkū
洞悉	dòngxī
洞穴	dòngxué
胴體	dòngtǐ
動產	dòngchǎn
*動蕩	dòngdàng
*動感	dònggǎn
*動工	dònggōng
動畫	dònghuà
動畫片	dònghuàpiàn
動氣	dòngqì
動容	dòngróng
動彈	dòng·tan
動聽	dòngtīng
動向	dòngxiàng
*動議	dòngyì
*動用	dòngyòng
動輒	dòngzhé
動作片	dòngzuòpiàn
棟	dòng
棟樑	dòngliáng
兜風	dōufēng
兜售	dōushòu
陡	dŏu
陡峭	dŏuqiào
豆瓣	dòubàn
豆豉	dòuchǐ
豆粉	dòufĕn
豆腐腦兒	dòu·funǎor
豆腐乳	dòu·furŭ
*豆漿	dòujiāng
豆蔻	dòukòu
*豆類	dòulèi
豆沙	dòushā
豆芽兒	dòuyár
*逗留	dòuliú
痘	dòu
鬥法	dòufǎ
*鬥牛	dòuniú
都市化	dūshìhuà
督	dū
督察	dūchá
*督導	dūdǎo
*毒品	dúpǐn
毒物	dúwù
*毒藥	dúyào
獨白	dúbái
獨步	dúbù
獨創	dúchuàng
獨當一面	dúdāngyīmiàn
獨到	dúdào
獨角獸	dújiǎoshòu
獨腳戲	dújiǎoxì
獨居	dújū
獨力	dúlì
獨門	dúmén
獨木舟	dúmùzhōu
獨樹一幟	dúshùyīzhì
獨一無二	dúyīwú'èr
*獨有	dúyŏu
*獨資	dúzī
*獨奏	dúzòu
讀法	dúfǎ
讀本	dúbĕn
讀後感	dúhòugǎn
讀書人	dúshūrén
*讀音	dúyīn
堵車	dŭchē
堵截	dŭjié
睹	dŭ
賭	dŭ
賭場	dŭchǎng
賭徒	dŭtú
賭注	dŭzhù
篤定	dŭdìng
篤信	dŭxìn
妒忌	dùjì
杜鵑	dùjuān
杜撰	dùzhuàn
肚	dù
*度假	dùjià
度假村	dùjiàcūn
度量	dùliàng
度量衡	dùliànghéng
渡過	dùguò
*渡輪	dùlún
端倪	duānní
*端午節	Duānwŭjié
端詳	duānxiáng
端詳	duān·xiang
端莊	duānzhuāng
短跑	duǎnpǎo
短篇	duǎnpiān
*短片	duǎnpiàn
短缺	duǎnquē
短視	duǎnshì
短途	duǎntú
短線	duǎnxiàn
短小	duǎnxiǎo
短信	duǎnxìn
短訊	duǎnxùn
段落	duànluò
鍛	duàn
斷層	duàncéng
斷裂	duànliè
斷然	duànrán
斷章取義	duànzhāngqŭyì
堆砌	duīqì
兌	duì
*兌換	duìhuàn
兌換券	duìhuànquàn
兌獎	duìjiǎng
兌取	duìqŭ
兌現	duìxiàn
隊友	duìyŏu
對白	duìbái
對調	duìdiào
對講機	duìjiǎngjī
對壘	duìlĕi
對偶	duì'ŏu
對談	duìtán
*對外	duìwài
對折	duìzhé
對症下藥	duìzhèngxiàyào
對峙	duìzhì
對質	duìzhì
敦促	dūncù
敦厚	dūnhòu
敦聘	dūnpìn
敦請	dūnqǐng
躉船	dŭnchuán
囤	dùn
鈍	dùn
盾	dùn
盾牌	dùnpái
燉	dùn
多才多藝	duōcáiduōyì
多愁善感	duōchóushàngǎn
多此一舉	duōcǐyījŭ
*多媒體	duōméitǐ
*多謝	duōxiè
*多樣	duōyàng
*多樣化	duōyànghuà
*多元	duōyuán
*多元化	duōyuánhuà
*多姿多采	duōzīduōcǎi
多嘴	duōzuǐ
奪標	duóbiāo
*奪得	duódé
奪冠	duóguàn
奪獎	duójiǎng
奪門	duómén
奪命	duómìng
*奪目	duómù
踱	duó
踱步	duóbù
舵	duò
惰	duò
惰性	duòxìng
欸	ê
*鵝肝	égān
額度	édù
額頭	étóu
*額外	éwài
噁心	ěxīn
扼	è
扼殺	èshā
扼要	èyào
愕然	èrán
遏抑	èyì
遏止	èzhǐ
遏制	èzhì
惡果	èguŏ
惡魔	èmó
惡習	èxí
惡性	èxìng
惡意	èyì
噩耗	èhào
噩夢	èmèng
*鱷魚	èyú
恩賜	ēncì
恩德	ēndé
恩怨	ēnyuàn
*而已	éryǐ
兒歌	érgē
兒化	érhuà
兒科	érkē
兒戲	érxì
耳環	ĕrhuán
耳機	ĕrjī
耳膜	ĕrmó
耳目	ĕrmù
耳目一新	ĕrmùyīxīn
耳熟能詳	ĕrshúnéngxiáng
餌	ĕr
二流子	èrliú·zi
二胡	èrhú
*二手	èrshŏu
發佈會	fābùhuì
發呆	fādāi
發單	fādān
發電廠	fādiànchǎng
發電機	fādiànjī
*發放	fāfàng
發憤	fāfèn
發憤圖強	fāfèntúqiáng
發奮	fāfèn
發還	fāhuán
*發酵	fājiào
發狂	fākuáng
發牢騷	fāláo·sāo
發愣	fālèng
發亮	fāliàng
發難	fānàn
發炮	fāpào
發球	fāqiú
發人深省	fārénshēnxǐng
發燒	fāshāo
發誓	fāshì
*發售	fāshòu
發送	fāsòng
發威	fāwēi
發問	fāwèn
發祥地	fāxiángdì
發笑	fāxiào
發泄	fāxiè
發信	fāxìn
*發行人	fāxíngrén
發言權	fāyánquán
*發言人	fāyánrén
發揚光大	fāyángguāngdà
發源	fāyuán
發源地	fāyuándì
*發展商	fāzhǎnshāng
乏	fá
乏力	fálì
乏味	fáwèi
伐	fá
筏	fá
閥	fá
*法案	fǎ'àn
法典	fǎdiǎn
*法規	fǎguī
法紀	fǎjì
法理	fǎlǐ
法力	fǎlì
法師	fǎshī
法事	fǎshì
*法治	fǎzhì
髮卡	fàqiǎ
髮式	fàshì
髮型	fàxíng
髮型師	fàxíngshī
帆	fān
帆布	fānbù
*帆船	fānchuán
蕃茄	fānqié
翻版	fānbǎn
翻滾	fāngŭn
翻天覆地	fāntiānfùdì
*翻新	fānxīn
翻修	fānxiū
翻閱	fānyuè
凡夫俗子	fánfūsúzǐ
凡間	fánjiān
凡事	fánshì
煩	fán
煩亂	fánluàn
煩悶	fánmèn
煩瑣	fánsuŏ
繁複	fánfù
*繁華	fánhuá
繁茂	fánmào
繁盛	fánshèng
繁瑣	fánsuŏ
繁星	fánxīng
繁衍	fányǎn
反串	fǎnchuàn
反方	fǎnfāng
反光	fǎnguāng
反撲	fǎnpū
*反彈	fǎntán
反胃	fǎnwèi
反省	fǎnxǐng
反轉	fǎnzhuǎn
返潮	fǎncháo
返璞歸真	fǎnpúguīzhēn
犯案	fàn'àn
犯不著	fàn·buzháo
犯規	fànguī
犯賤	fànjiàn
販	fàn
販毒	fàndú
販運	fànyùn
飯菜	fàncài
飯廳	fàntīng
飯桌	fànzhuō
範本	fànbĕn
範例	fànlì
範文	fànwén
方便麵	fāngbiànmiàn
方程式	fāngchéngshì
方位	fāngwèi
方向感	fāngxiànggǎn
方興未艾	fāngxīngwèi'ài
方正	fāng·zhèng
*坊間	fāngjiān
*芳香	fāngxiāng
防不勝防	fángbùshèngfáng
防備	fángbèi
防盜	fángdào
防範	fángfàn
防腐劑	fángfŭjì
防洪	fánghóng
*防護	fánghù
防患未然	fánghuànwèirán
防火	fánghuŏ
防曬	fángshài
防曬油	fángshàiyóu
*防守	fángshŏu
防水	fángshuǐ
防衛	fángwèi
*防疫	fángyì
房產	fángchǎn
*房地產	fángdìchǎn
房舍	fángshè
仿	fǎng
仿冒	fǎngmào
仿傚	fǎngxiào
仿照	fǎngzhào
仿製	fǎngzhì
紡	fǎng
*紡織品	fǎngzhīpǐn
*訪客	fǎngkè
訪問團	fǎngwèntuán
放榜	fàngbǎng
*放緩	fànghuǎn
放火	fànghuŏ
放假	fàngjià
放寬	fàngkuān
放款	fàngkuǎn
放牧	fàngmù
放任	fàngrèn
放肆	fàngsì
放生	fàngshēng
放手	fàngshŏu
放眼	fàngyǎn
放映	fàngyìng
*放置	fàngzhì
*放逐	fàngzhú
放縱	fàngzòng
非凡	fēifán
菲傭	fēiyōng
緋聞	fēiwén
蜚聲	fēishēng
飛車	fēichē
飛鳥	fēiniǎo
飛禽走獸	fēiqínzŏushòu
飛人	fēirén
飛天	fēitiān
飛舞	fēiwŭ
飛檐走壁	fēiyánzŏubì
飛揚	fēiyáng
飛越	fēiyuè
*肥胖	féipàng
肥肉	féiròu
匪夷所思	fĕiyísuŏsī
斐然	fĕirán
*翡翠	fĕicuì
沸	fèi
沸水	fèishuǐ
*肺炎	fèiyán
費解	fèijiĕ
費勁	fèijìn
費神	fèishén
費時	fèishí
痱子	fèi·zi
廢料	fèiliào
*廢氣	fèiqì
廢棄	fèiqì
廢水	fèishuǐ
*廢物	fèiwù
廢紙	fèizhǐ
分貝	fēnbèi
*分擔	fēndān
*分隔	fēngé
分行	fēnháng
分毫	fēnháo
分居	fēnjū
分門別類	fēnménbiélèi
分泌物	fēnmìwù
分娩	fēnmiǎn
*分期	fēnqī
*分區	fēnqū
*分手	fēnshŏu
*分數	fēnshù
分攤	fēntān
分庭抗禮	fēntíngkànglǐ
*分享	fēnxiǎng
*分銷	fēnxiāo
分憂	fēnyōu
分賬	fēnzhàng
芬芳	fēnfāng
氛圍	fēnwéi
紛飛	fēnfēi
紛亂	fēnluàn
紛紜	fēnyún
紛爭	fēnzhēng
紛至沓來	fēnzhìtàlái
焚	fén
焚燒	fénshāo
墳	fén
墳場	fénchǎng
墳墓	fénmù
粉筆	fěnbǐ
粉飾	fěnshì
粉筆末兒	fěnbǐmòr
粉紅	fĕnhóng
粉絲	fĕnsī
粉飾	fĕnshì
憤	fèn
憤懣	fènmèn
奮不顧身	fènbùgùshēn
奮發	fènfā
奮力	fènlì
*糞便	fènbiàn
風波	fēngbō
*風采	fēngcǎi
風潮	fēngcháo
風車	fēngchē
風塵	fēngchén
風馳電掣	fēngchídiànchè
風帆	fēngfān
風範	fēngfàn
風和日麗	fēnghérìlì
風花雪月	fēnghuāxuĕyuè
風化	fēnghuà
風流	fēngliú
*風貌	fēngmào
風靡	fēngmǐ
*風情	fēngqíng
風騷	fēngsāo
風扇	fēngshàn
風聲	fēngshēng
風濕病	fēngshībìng
風勢	fēngshì
風霜	fēngshuāng
*風水	fēng·shuǐ
風調雨順	fēngtiáoyŭshùn
風頭	fēng·tou
風土	fēngtŭ
風雪	fēngxuĕ
*風味	fēngwèi
風向	fēngxiàng
風行	fēngxíng
風衣	fēngyī
風韻	fēngyùn
風姿	fēngzī
楓	fēng
楓樹	fēngshù
楓葉	fēngyè
瘋	fēng
封存	fēngcún
封面	fēngmiàn
封套	fēngtào
封條	fēngtiáo
峰迴路轉	fēnghuílùzhuǎn
烽火	fēnghuŏ
蜂擁而至	fēngyōng'érzhì
鋒芒	fēngmáng
鋒芒畢露	fēngmángbìlù
風頭	fēng·tou
*豐厚	fēnghòu
豐潤	fēngrùn
豐盛	fēngshèng
豐碩	fēngshuò
豐衣足食	fēngyīzúshí
豐腴	fēngyú
逢	féng
諷	fĕng
諷喻	fĕngyù
奉公守法	fènggōngshŏufǎ
奉命	fèngmìng
奉陪	fèngpéi
*奉行	fèngxíng
鳳	fèng
*鳳梨	fènglí
佛經	fójīng
佛寺	fósì
佛陀	Fótuó
*佛像	fóxiàng
佛學	fóxué
佛珠	fózhū
佛祖	fózŭ
敷	fū
敷設	fūshè
孵	fū
膚淺	fūqiǎn
膚色	fūsè
伏案	fú'àn
伏筆	fúbǐ
伏線	fúxiàn
扶持	fúchí
扶貧	fúpín
扶弱	fúruò
*扶手	fúshŏu
扶手電梯	fúshŏudiàntī
扶植	fúzhí
扶助	fúzhù
芙蓉	fúróng
服侍	fú·shi
服食	fúshí
*服飾	fúshì
*服務費	fúwùfèi
服刑	fúxíng
*服用	fúyòng
拂	fú
俘	fú
浮沉	fúchén
浮華	fúhuá
浮現	fúxiàn
符	fú
福蔭	fúyìn
福祉	fúzhǐ
輻	fú
輻照	fúzhào
俯	fŭ
俯瞰	fŭkàn
俯身	fŭshēn
俯拾皆是	fŭshíjiēshì
俯視	fŭshì
腐乳	fŭrŭ
輔	fŭ
輔幣	fŭbì
輔導	fŭdǎo
輔導員	fŭdǎoyuán
輔佐	fŭzuŏ
撫	fŭ
撫平	fŭpíng
撫慰	fŭwèi
父	fù
父老	fùlǎo
父母親	fùmŭqīn
父親節	fù·qīnjié
父子	fùzǐ
付費	fùfèi
*付款	fùkuǎn
付運	fùyùn
*附表	fùbiǎo
附加值	fùjiāzhí
*附件	fùjiàn
*附錄	fùlù
附設	fùshè
*附屬	fùshŭ
附註	fùzhù
*負荷	fùhè
負累	fùlĕi
負離子	fùlízǐ
*負面	fùmiàn
負數	fùshù
負載	fùzài
*負責人	fùzérén
*負債	fùzhài
*副本	fùbĕn
副刊	fùkān
副食	fùshí
副題	fùtí
富貴	fùguì
*富豪	fùháo
富麗	fùlì
富麗堂皇	fùlìtánghuáng
富饒	fùráo
富商	fùshāng
婦女節	Fùnǚjié
復仇	fùchóu
復出	fùchū
復發	fùfā
復古	fùgŭ
復甦	fùsū
*復原	fùyuán
腹部	fùbù
腹瀉	fùxiè
複製品	fùzhìpǐn
覆	fù
覆蓋面	fùgàimiàn
*覆核	fùhé
覆水難收	fùshuǐnánshōu
賦閒	fùxián
縛	fù
夾肢窩	gā·zhiwō
*咖喱	gālí
該死	gāisǐ
*改道	gǎidào
*改動	gǎidòng
改觀	gǎiguān
改過自新	gǎiguòzìxīn
改嫁	gǎijià
*改建	gǎijiàn
改期	gǎiqī
改天	gǎitiān
改寫	gǎixiĕ
*改用	gǎiyòng
*鈣質	gàizhì
蓋世	gàishì
蓋印	gàiyìn
概	gài
概覽	gàilǎn
概略	gàilüè
概述	gàishù
干犯	gānfàn
*肝炎	gānyán
甘	gān
甘草	gāncǎo
甘露	gānlù
甘甜	gāntián
甘油	gānyóu
甘願	gānyuàn
甘蔗	gān·zhe
柑	gān
柑橘	gānjú
竿	gān
乾爹	gāndiē
乾涸	gānhé
乾貨	gānhuò
乾果	gānguŏ
乾媽	gānmā
乾爽	gānshuǎng
尷尬	gāngà
感恩	gǎn'ēn
感觸	gǎnchù
感懷	gǎnhuái
感冒	gǎnmào
感染力	gǎnrǎnlì
*感人	gǎnrén
感傷	gǎnshāng
感嘆	gǎntàn
感悟	gǎnwù
感召	gǎnzhào
趕不上	gǎn·bushàng
趕得上	gǎn·deshàng
趕工	gǎngōng
*橄欖	gǎnlǎn
*橄欖油	gǎnlǎnyóu
橄欖樹	gǎnlǎnshù
幹練	gànliàn
幹事	gàn·shi
*幹線	gànxiàn
缸	gāng
*剛好	gānghǎo
剛勁	gāngjìng
剛巧	gāngqiǎo
鋼筋	gāngjīn
鋼琴家	gāngqínjiā
崗	gǎng
*港府	Gǎngfŭ
港人	Gǎngrén
*港商	Gǎngshāng
*港式	Gǎngshì
高昂	gāo'áng
高傲	gāo'ào
*高層	gāocéng
高處	gāochù
高低	gāodī
高調	gāodiào
*高爾夫球	gāo'ĕrfūqiú
*高峰	gāofēng
高官	gāoguān
*高價	gāojià
高架橋	gāojiàqiáo
高見	gāojiàn
高踞	gāojù
*高科技	gāokējì
高齡	gāolíng
高人	gāorén
高聳	gāosŏng
高聳入雲	gāosŏngrùyún
高談闊論	gāotánkuòlùn
*高位	gāowèi
高效	gāoxiào
高薪	gāoxīn
高雅	gāoyǎ
高瞻遠矚	gāozhānyuǎnzhŭ
高招	gāozhāo
糕	gāo
*糕點	gāodiǎn
告吹	gàochuī
告發	gàofā
告示	gào·shi
告示牌	gào·shipái
*告知	gàozhī
告終	gàozhōng
戈壁	gēbì
割裂	gēliè
割讓	gēràng
歌唱家	gēchàngjiā
*歌詞	gēcí
*歌劇院	gējùyuàn
歌迷	gēmí
*歌手	gēshŏu
歌壇	gētán
歌謠	gēyáo
擱淺	gēqiǎn
擱置	gēzhì
革	gé
革職	gézhí
格調	gédiào
格格不入	gégébùrù
格律	gélǜ
*格式	géshì
格言	géyán
隔膜	gémó
隔世	géshì
隔靴搔癢	géxuēsāoyǎng
隔夜	géyè
隔音	géyīn
閣	gé
閣樓	gélóu
閣下	géxià
*葛	Gĕ
各個	gè·ge
各就各位	gèjiùgèwèi
各有所長	gèyŏusuŏcháng
*個案	gè'àn
*個人化	gèrénhuà
根部	gēnbù
根底	gēndǐ
根基	gēnjī
根莖	gēnjīng
根治	gēnzhì
跟從	gēncóng
*跟進	gēnjìn
*跟著	gēn·zhe
*更換	gēnghuàn
更年期	gēngniánqī
*更生	gēngshēng
更替	gēngtì
更衣	gēngyī
更易	gēngyì
耕耘	gēngyún
羹	gēng
哽咽	gĕngyè
梗	gĕng
梗概	gĕnggài
梗兒	gěngr
耿	gĕng
耿耿於懷	gĕnggĕngyúhuái
工匠	gōngjiàng
工時	gōngshí
工作日	gōngzuòrì
*工作者	gōngzuòzhĕ
公廁	gōngcè
公法	gōngfǎ
公幹	gōnggàn
*公會	gōnghuì
*公積金	gōngjījīn
公爵	gōngjué
公開賽	gōngkāisài
公開信	gōngkāixìn
*公立	gōnglì
公僕	gōngpú
公升	gōngshēng
公式化	gōngshìhuà
公事	gōngshì
公事包	gōngshìbāo
公私	gōngsī
*公務員	gōngwùyuán
*公屋	gōngwū
公務	gōngwù
公演	gōngyǎn
公益	gōngyì
公益金	gōngyìjīn
*公營	gōngyíng
公映	gōngyìng
公寓	gōngyù
*公約	gōngyuē
公證	gōngzhèng
*公證人	gōngzhèngrén
公證書	gōngzhèngshū
*公職	gōngzhí
*公眾	gōngzhòng
弓箭	gōngjiàn
躬	gōng
功不可沒	gōngbùkĕmò
功勞	gōng·láo
功力	gōnglì
功利	gōnglì
*功效	gōngxiào
功用	gōngyòng
攻打	gōngdǎ
攻略	gōnglüè
攻勢	gōngshì
攻陷	gōngxiàn
供不應求	gōngbùyìngqiú
供養	gōngyǎng
恭賀	gōnghè
恭候	gōnghòu
*恭喜	gōngxǐ
拱形	gŏngxíng
*共識	gòngshí
共通點	gòngtōngdiǎn
供詞	gòngcí
*供奉	gòngfèng
供認	gòngrèn
供養	gòngyǎng
貢	gòng
勾	gōu
勾畫	gōuhuà
勾勒	gōulè
勾住	gōuzhù
溝渠	gōuqú
枸杞	gŏuqǐ
勾當	gòu·dàng
垢	gòu
夠格	gòugé
構建	gòujiàn
構築	gòuzhù
構築物	gòuzhùwù
購價	gòujià
*購物	gòuwù
*購置	gòuzhì
估	gū
*估價	gūjià
估量	gū·liáng
估算	gūsuàn
咕嚕	gūlū
咕嚕	gū·lu
姑母	gūmŭ
姑息	gūxī
姑丈	gūzhàng
菇	gū
孤	gū
孤兒	gū'ér
孤兒院	gū'éryuàn
孤魂野鬼	gūhúnyĕguǐ
孤寂	gūjì
孤軍作戰	gūjūnzuòzhàn
孤苦	gūkŭ
孤零零	gūlínglíng
孤陋寡聞	gūlòuguǎwén
孤僻	gūpì
骨碌	gū·lu
古板	gŭbǎn
古剎	gŭchà
*古董	gŭdŏng
古籍	gŭjí
*古蹟	gŭjì
古舊	gŭjiù
古蘭經	Gŭlánjīng
古墓	gŭmù
古樸	gŭpŭ
古琴	gŭqín
古色古香	gŭsègŭxiāng
古詩	gŭshī
古式	gŭshì
古塔	gŭtǎ
古玩	gŭwán
古屋	gŭwū
古物	gŭwù
古雅	gŭyǎ
古語	gŭyŭ
古樂	gŭyuè
古箏	gŭzhēng
古裝	gŭzhuāng
*股本	gŭbĕn
*股東	gŭdōng
*股份	gŭfèn
*股價	gŭjià
股民	gŭmín
*股權	gŭquán
股權證	gŭquánzhèng
*股市	gŭshì
*股息	gŭxī
骨灰	gŭhuī
骨架	gŭjià
骨科	gŭkē
*骨髓	gŭsuǐ
骨折	gŭzhé
*骨質	gŭzhì
鼓樓	gŭlóu
鼓手	gŭshŏu
鼓樂	gŭyuè
穀物	gŭwù
蠱惑	gŭhuò
固態	gùtài
固網	gùwǎng
故此	gùcǐ
故宮	gùgōng
故居	gùjū
故里	gùlǐ
故弄玄虛	gùnòngxuánxū
故事片	gùshipiàn
故園	gùyuán
*僱用	gùyòng
*僱主	gùzhŭ
顧及	gùjí
顧忌	gùjì
顧名思義	gùmíngsīyì
瓜果	guāguŏ
瓜子	guāzǐ
刮目相看	guāmùxiāngkàn
寡	guǎ
寡頭	guǎtóu
卦	guà
掛號信	guàhàoxìn
掛牌	guàpái
掛帥	guàshuài
掛賬	guàzhàng
乖	guāi
乖巧	guāiqiǎo
枴杖	guǎizhàng
怪不得	guài·bù·dé
怪誕	guàidàn
怪異	guàiyì
官場	guānchǎng
官邸	guāndǐ
*官方	guānfāng
官服	guānfú
*官司	guān·si
冠心病	guānxīnbìng
關愛	guān'ài
關乎	guānhū
關連	guānlián
關門	guānmén
關卡	guānqiǎ
*關稅	guānshuì
關押	guānyā
關子	guān·zi
觀感	guāngǎn
*觀光	guānguāng
觀摩	guānmó
*觀賞	guānshǎng
觀望	guānwàng
觀音	Guānyīn
觀照	guānzhào
管教	guǎnjiào
管束	guǎnshù
*管弦樂	guǎnxiányuè
*管制	guǎnzhì
*管治	guǎnzhì
*館藏	guǎncáng
貫徹始終	guànchèshǐzhōng
貫通	guàntōng
慣常	guàncháng
*灌輸	guànshū
灌注	guànzhù
罐	guàn
*罐頭	guàn·tou
光采	guāngcǎi
*光碟	guāngdié
*光顧	guānggù
光環	guānghuán
光纜	guānglǎn
光陰	guāngyīn
光影	guāngyǐng
廣博	guǎngbó
廣袤	guǎngmào
逛街	guàngjiē
皈依	guīyī
規	guī
規範化	guīfànhuà
*規例	guīlì
規律	guīlǜ
規章	guīzhāng
瑰寶	guībǎo
瑰麗	guīlì
歸化	guīhuà
歸咎	guījiù
*歸屬	guīshŭ
歸宿	guīsù
龜	guī
軌	guǐ
軌跡	guǐjì
鬼斧神工	guǐfŭshéngōng
鬼怪	guǐguài
鬼魂	guǐhún
鬼臉	guǐliǎn
鬼魅	guǐmèi
鬼門關	guǐménguān
鬼祟	guǐsuì
詭異	guǐyì
桂花	guìhuā
桂圓	guìyuán
*貴賓	guìbīn
櫃	guì
*櫃檯	guìtái
*櫃員機	guìyuánjī
滾蛋	gŭndàn
滾瓜爛熟	gŭnguālànshú
棍	gùn
鍋巴	guōbā
鍋蓋	guōgài
國寶	guóbǎo
國粹	guócuì
*國道	guódào
國度	guódù
國歌	guógē
國畫	guóhuà
*國籍	guójí
國際化	guójìhuà
國腳	guójiǎo
國界	guójiè
國境	guójìng
國庫	guókù
國立	guólì
*國企	guóqǐ
國慶	guóqìng
國務	guówù
國務卿	guówùqīng
國學	guóxué
*國語	guóyŭ
國債	guózhài
果凍	guŏdòng
果醬	guŏjiàng
*果皮	guŏpí
果仁	guŏrén
果肉	guŏròu
果糖	guŏtáng
果園	guŏyuán
果真	guŏzhēn
果汁	guŏzhī
果子	guŏ·zi
過半	guòbàn
過錯	guòcuò
過冬	guòdōng
*過海	guòhǎi
過活	guòhuó
過火	guòhuŏ
過獎	guòjiǎng
過節	guòjié
*過境	guòjìng
過客	guòkè
*過量	guòliàng
過路	guòlù
過敏	guòmǐn
過敏原	guòmǐnyuán
過期	guòqī
過氣	guòqì
過熱	guòrè
過人	guòrén
過山車	guòshānchē
過時	guòshí
過世	guòshì
*過往	guòwǎng
過夜	guòyè
過意不去	guòyìbùqù
過癮	guòyǐn
孩童	háitóng
骸骨	háigŭ
海岸線	hǎi'ànxiàn
*海報	hǎibào
海豹	hǎibào
*海產	hǎichǎn
海潮	hǎicháo
海膽	hǎidǎn
海島	hǎidǎo
海道	hǎidào
*海盜	hǎidào
*海防	hǎifáng
海風	hǎifēng
*海港	hǎigǎng
海龜	hǎiguī
*海口	hǎikŏu
海闊天空	hǎikuòtiānkōng
海浪	hǎilàng
海螺	hǎiluó
海綿	hǎimián
海鳥	hǎiniǎo
海鷗	hǎi'ōu
海參	hǎishēn
海獅	hǎishī
*海事	hǎishì
*海水	hǎishuǐ
*海灘	hǎitān
海豚	hǎitún
海味	hǎiwèi
*海峽	hǎixiá
海峽兩岸	Hǎixiáliǎng'àn
*海鮮	hǎixiān
海嘯	hǎixiào
海鹽	hǎiyán
*海魚	hǎiyú
海員	hǎiyuán
*海運	hǎiyùn
海藻	hǎizǎo
害羞	hàixiū
駭	hài
駭客	hàikè
含苞待放	hánbāodàifàng
含笑	hánxiào
*含蓄	hánxù
含意	hányì
函	hán
函件	hánjiàn
*涵蓋	hángài
涵義	hányì
寒風	hánfēng
寒噤	hánjìn
寒流	hánliú
寒暄	hánxuān
寒意	hányì
韓	Hán
罕	hǎn
*罕有	hǎnyŏu
汗衫	hànshān
汗顏	hànyán
焊	hàn
焊接	hànjiē
憾	hàn
翰	hàn
行規	hángguī
行情	hángqíng
航	háng
*航班	hángbān
航程	hángchéng
航次	hángcì
航道	hángdào
航海家	hánghǎijiā
航空母艦	hángkōngmŭjiàn
*航線	hángxiàn
*航運	hángyùn
毫	háo
毫克	háokè
*毫米	háomǐ
毫升	háoshēng
*亳無	háowú
豪	háo
豪放	háofàng
*豪華	háohuá
豪邁	háomài
豪氣	háoqì
豪情	háoqíng
豪爽	háoshuǎng
豪宅	háozhái
壕	háo
壕溝	háogōu
蠔	háo
蠔油	háoyóu
好歹	hǎodǎi
好好兒	hǎohāor
好評	hǎopíng
好事多磨	hǎoshìduōmó
好手	hǎoshŏu
好玩兒	hǎowánr
好戲	hǎoxì
好笑	hǎoxiào
好心	hǎoxīn
好樣兒	hǎoyàngr
好意	hǎoyì
好動	hàodòng
好奇心	hàoqíxīn
好學	hàoxué
浩瀚	hàohàn
浩劫	hàojié
浩然	hàorán
耗電	hàodiàn
耗盡	hàojìn
耗用	hàoyòng
耗資	hàozī
號碼	hàomǎ
號手	hàoshŏu
號外	hàowài
呵護	hēhù
喝茶	hēchá
喝水	hēshuǐ
喝醉	hēzuì
*合唱	héchàng
*合唱團	héchàngtuán
*合共	hégòng
合夥	héhuŏ
*合夥人	héhuŏrén
合拍	hépāi
合算	hésuàn
合演	héyǎn
合影	héyǐng
*合約	héyuē
合照	hézhào
*合奏	hézòu
何妨	héfáng
何謂	héwèi
河堤	hédī
河谷	hégŭ
河馬	hémǎ
河水	héshuǐ
和藹	hé'ǎi
和緩	héhuǎn
*和解	héjiĕ
和暖	hénuǎn
和善	héshàn
和弦	héxián
核彈	hédàn
核彈頭	hédàntóu
核電	hédiàn
*核對	héduì
核能	hénéng
*核實	héshí
*核准	hézhŭn
核子	hézǐ
荷爾蒙	hé'ĕrméng
荷花	héhuā
荷葉	héyè
喝彩	hècǎi
褐	hè
賀	hè
賀歲片	hèsuìpiàn
赫	hè
赫然	hèrán
*黑白	hēibǎi
*黑板	hēibǎn
黑點	hēidiǎn
黑馬	hēimǎ
黑社會	hēishèhuì
嘿	hēi
痕	hén
狠	hĕn
狠心	hĕnxīn
亨通	hēngtōng
哼	hēng
恆久	héngjiŭ
恆溫	héngwēn
恆心	héngxīn
衡	héng
橫渡	héngdù
橫街	héngjiē
橫跨	héngkuà
橫掃	héngsǎo
橫溢	héngyì
橫財	hèngcái
哄堂	hōngtáng
烘	hōng
烘焙	hōngbèi
烘熱	hōngrè
烘托	hōngtuō
洪荒	hónghuāng
洪流	hóngliú
*紅包	hóngbāo
紅潮	hóngcháo
紅塵	hóngchén
*紅燈	hóngdēng
紅豆	hóngdòu
紅火	hóng·huo
*紅酒	hóngjiŭ
*紅利	hónglì
紅棉	hóngmián
紅潤	hóngrùn
紅血球	hóngxuèqiú
紅腫	hóngzhŏng
虹	hóng
弘揚	hóngyáng
宏揚	hóngyáng
宏願	hóngyuàn
鬨動	hòngdòng
喉	hóu
喉管	hóuguǎn
喉嚨	hóu·long
喉頭	hóutóu
厚薄	hòubó
厚實	hòu·shi
厚望	hòuwàng
厚重	hòuzhòng
*後備	hòubèi
後輩	hòubèi
後塵	hòuchén
後盾	hòudùn
後防	hòufáng
後宮	hòugōng
後顧之憂	hòugùzhīyōu
後悔莫及	hòuhuǐmòjí
後記	hòujì
後進	hòujìn
後門	hòumén
後腦勺兒	hòunǎosháor
後起之秀	hòuqǐzhīxiù
*後勤	hòuqín
後嗣	hòusì
後台	hòutái
後衛	hòuwèi
後遺症	hòuyízhèng
後裔	hòuyì
*後者	hòuzhĕ
後座	hòuzuò
*候車	hòuchē
候鳥	hòuniǎo
候任	hòurèn
候審	hòushĕn
候選	hòuxuǎn
*候選人	hòuxuǎnrén
呼風喚雨	hūfēnghuànyŭ
呼號	hūháo
呼救	hūjiù
*呼吸道	hūxīdào
呼應	hūyìng
狐疑	húyí
弧度	húdù
弧形	húxíng
*胡椒	hújiāo
胡椒粉	hújiāofĕn
胡蘿蔔	húluó·bo
胡蘿蔔素	húluó·bosù
胡鬧	húnào
胡琴	húqín
胡思亂想	húsīluànxiǎng
胡桃	hútáo
湖畔	húpàn
湖水	húshuǐ
糊	hú
糊口	húkŏu
鬍子	hú·zi
虎視眈眈	hŭshìdāndān
琥珀	hŭpò
*互動	hùdòng
互訪	hùfǎng
互換	hùhuàn
互惠	hùhuì
互利	hùlì
*互聯網	hùliánwǎng
*戶外	hùwài
戶主	hùzhŭ
護膚	hùfū
護膚品	hùfūpǐn
護欄	hùlán
*護理	hùlǐ
護送	hùsòng
護衛	hùwèi
花白	huābái
花瓣	huābàn
花布	huābù
花草	huācǎo
花茶	huāchá
花車	huāchē
花叢	huācóng
花旦	huādàn
花燈	huādēng
花崗岩	huāgāngyán
花紅	huāhóng
花卉	huāhuì
*花椒	huājiāo
花轎	huājiào
花蕾	huālĕi
花蜜	huāmì
花盆	huāpén
花瓶	huāpíng
花圃	huāpŭ
花蕊	huāruǐ
花生油	huāshēngyóu
花市	huāshì
花絮	huāxù
花言巧語	huāyánqiǎoyŭ
花藝	huāyì
划船	huáchuán
划算	huásuàn
*華麗	huálì
*華人	huárén
華裔	huáyì
華語	huáyŭ
滑稽	huá·jī
滑溜	huá·liu
滑落	huáluò
滑嫩	huánèn
滑鼠	huáshŭ
滑頭	huátóu
滑翔	huáxiáng
滑行	huáxíng
*滑雪	huáxuĕ
*化身	huàshēn
化為烏有	huàwéiwūyŏu
化險為夷	huàxiǎnwéiyí
*化驗	huàyàn
畫冊	huàcè
畫風	huàfēng
畫廊	huàláng
畫龍點睛	huàlóngdiǎnjīng
畫派	huàpài
畫蛇添足	huàshétiānzú
畫壇	huàtán
畫像	huàxiàng
畫展	huàzhǎn
劃時代	huàshídài
劃一	huàyī
*話劇團	huàjùtuán
話音	huàyīn
淮	huái
*懷舊	huáijiù
*懷孕	huáiyùn
壞事	huàishì
歡	huān
歡快	huānkuài
歡心	huānxīn
歡欣	huānxīn
歡愉	huānyú
還擊	huánjī
還價	huánjià
還俗	huánsú
還債	huánzhài
*環保	huánbǎo
環抱	huánbào
環環相扣	huánhuánxiāngkòu
*環球	huánqiú
*環繞	huánrào
*環線	huánxiàn
環遊	huányóu
緩步	huǎnbù
緩衝	huǎnchōng
緩急	huǎnjí
緩解	huǎnjiĕ
緩刑	huǎnxíng
幻	huàn
幻燈	huàndēng
幻燈片	huàndēngpiàn
幻化	huànhuà
幻滅	huànmiè
*幻想	huànxiǎng
幻象	huànxiàng
幻影	huànyǐng
*患病	huànbìng
喚醒	huànxǐng
*換取	huànqŭ
煥發	huànfā
煥然一新	huànrányīxīn
荒廢	huāngfèi
荒漠	huāngmò
荒蕪	huāngwú
荒野	huāngyĕ
皇	huáng
*皇家	huángjiā
皇室	huángshì
*黃豆	huángdòu
簧	huáng
惶惑	huánghuò
惶恐	huángkŏng
遑論	huánglùn
恍惚	huǎnghū
恍然	huǎngrán
晃眼	huǎngyǎn
幌子	huǎng·zi
謊	huǎng
謊話	huǎnghuà
謊言	huǎngyán
晃動	huàngdòng
灰飛煙滅	huīfēiyānmiè
灰燼	huījìn
灰蒙蒙	huīmēngmēng
恢宏	huīhóng
詼諧	huīxié
揮動	huīdòng
揮發	huīfā
揮霍	huīhuò
揮灑	huīsǎ
揮手	huīshŏu
輝	huī
輝映	huīyìng
徽	huī
徽章	huīzhāng
*回報	huíbào
回程	huíchéng
*回復	huífù
*回合	huíhé
回扣	huíkòu
*回饋	huíkuì
回流	huíliú
*回落	huíluò
回暖	huínuǎn
*回升	huíshēng
*回收	huíshōu
回首	huíshŏu
回望	huíwàng
*回味	huíwèi
回鄉	huíxiāng
回響	huíxiǎng
回憶錄	huíyìlù
*回應	huíyìng
*回贈	huízèng
回轉	huízhuǎn
迴盪	huídàng
迴旋	huíxuán
茴香	huíxiāng
悔	huǐ
彗星	huìxīng
慧	huì
惠	huì
惠顧	huìgù
惠及	huìjí
會話	huìhuà
會徽	huìhuī
*會考	huìkǎo
*會面	huìmiàn
*會所	huìsuŏ
*會同	huìtóng
*會晤	huìwù
會展	huìzhǎn
*會長	huìzhǎng
薈萃	huìcuì
繪製	huìzhì
匯	huì
匯兌	huìduì
*匯價	huìjià
*匯聚	huìjù
*匯款	huìkuǎn
*匯率	huìlǜ
匯票	huìpiào
匯市	huìshì
*匯演	huìyǎn
*彙報	huìbào
*彙集	huìjí
諱言	huìyán
昏	hūn
昏暗	hūn'àn
昏黃	hūnhuáng
昏厥	hūnjué
昏睡	hūnshuì
婚嫁	hūnjià
婚紗	hūnshā
婚宴	hūnyàn
渾	hún
渾身解數	húnshēnxièshù
魂魄	húnpò
餛飩	hún·tun
混沌	hùndùn
*混和	hùnhé
混日子	hùnrì·zi
混為一談	hùnwéiyītán
混血兒	hùnxuè'ér
混雜	hùnzá
混戰	hùnzhàn
豁	huō
活化	huóhuà
活靈活現	huólínghuóxiàn
*活期	huóqī
活生生	huóshēngshēng
活脫兒	huótuōr
活性	huóxìng
活學活用	huóxuéhuóyòng
火爆	huŏbào
火車頭	huŏchētóu
*火鍋	huŏguō
火海	huŏhǎi
火紅	huŏhóng
火花	huŏhuā
*火化	huŏhuà
火雞	huŏjī
*火警	huŏjǐng
火辣辣	huŏlālā
火爐	huŏlú
火炮	huŏpào
火熱	huŏrè
火舌	huŏshé
火勢	huŏshì
火速	huŏsù
火炭	huŏtàn
*火腿	huŏtuǐ
火藥	huŏyào
火葬	huŏzàng
伙	huŏ
惑	huò
貨場	huòchǎng
*貨車	huòchē
貨船	huòchuán
貨單	huòdān
*貨櫃	huòguì
貨機	huòjī
貨架	huòjià
貨款	huòkuǎn
貨流	huòliú
*貨品	huòpǐn
貨色	huòsè
貨箱	huòxiāng
貨源	huòyuán
*貨運	huòyùn
貨站	huòzhàn
貨真價實	huòzhēnjiàshí
禍	huò
禍根	huògēn
*獲獎	huòjiǎng
*獲利	huòlì
獲悉	huòxī
獲知	huòzhī
*獲准	huòzhŭn
霍	huò
霍亂	huòluàn
霍然	huòrán
豁達	huòdá
*豁免	huòmiǎn
豁然	huòrán
肌膚	jīfū
飢	jī
*基本法	Jībĕnfǎ
基本功	jībĕngōng
基地	jīdì
基點	jīdiǎn
基調	jīdiào
基金	jījīn
*基金會	jījīnhuì
基石	jīshí
基數	jīshù
基因	jīyīn
基於	jīyú
*基準	jīzhŭn
幾率	jīlǜ
機艙	jīcāng
*機電	jīdiàn
*機動	jīdòng
機件	jījiàn
機靈	jī·ling
*機票	jīpiào
機師	jīshī
機鐵	jītiĕ
機位	jīwèi
機油	jīyóu
機組	jīzŭ
饑寒交迫	jīhánjiāopò
饑饉	jījǐn
畸型	jīxíng
稽查	jīchá
稽核	jīhé
激昂	jī'áng
激蕩	jīdàng
激流	jīliú
*激增	jīzēng
積存	jīcún
*積分	jīfēn
積聚	jījù
積勞成疾	jīláochéngjí
積木	jīmù
積蓄	jīxù
積雪	jīxuĕ
*擊敗	jībài
擊退	jītuì
擊中	jīzhòng
雞尾酒	jīwĕijiŭ
雞蛋	jīdàn
雞肋	jīlèi
*雞肉	jīròu
*躋身	jīshēn
羈留	jīliú
羈押	jīyā
及第	jídì
*及早	jízǎo
及至	jízhì
*汲取	jíqŭ
吉	jí
吉利	jílì
吉祥	jíxiáng
吉祥物	jíxiángwù
即刻	jíkè
*即日	jírì
*即時	jíshí
即使	jíshǐ
即席	jíxí
急促	jícù
急救	jíjiù
急流	jíliú
*急升	jíshēng
*急速	jísù
急增	jízēng
急診	jízhĕn
*急症	jízhèng
急轉直下	jízhuǎnzhíxià
疾	jí
疾苦	jíkŭ
嫉妒	jídù
*級別	jíbié
集結	jíjié
集散	jísàn
集市	jíshì
集思廣益	jísīguǎngyì
集訓	jíxùn
集裝箱	jízhuāngxiāng
極地	jídì
極點	jídiǎn
*極度	jídù
極品	jípǐn
棘手	jíshŏu
輯	jí
輯錄	jílù
紀	Jǐ
給與	jǐyŭ
幾時	jǐshí
幾許	jǐxŭ
擠壓	jǐyā
技法	jìfǎ
技工	jìgōng
技師	jìshī
忌	jì
忌諱	jìhuì
忌口	jìkŏu
紀錄片	jìlùpiàn
紀念碑	jìniànbēi
紀念館	jìniànguǎn
*紀念品	jìniànpǐn
紀念日	jìniànrì
紀事	jìshì
記名	jìmíng
記事	jìshì
記事簿	jìshìbù
記述	jìshù
記敘	jìxù
記憶猶新	jìyìyóuxīn
記賬	jìzhàng
*季度	jìdù
季軍	jìjūn
季刊	jìkān
*計程車	jìchéngchē
計分	jìfēn
計畫書	jìhuàshū
計量	jìliàng
寂	jì
寄存	jìcún
寄居	jìjū
寄情	jìqíng
寄宿	jìsù
寄信	jìxìn
寄養	jìyǎng
寄予	jìyŭ
寄寓	jìyù
祭拜	jìbài
祭品	jìpǐn
祭壇	jìtán
冀	jì
冀望	jìwàng
績效	jìxiào
劑量	jìliàng
覬覦	jìyú
繼承權	jìchéngquán
*繼而	jì'ér
繼任	jìrèn
繼往開來	jìwǎngkāilái
加倍	jiābèi
加碼	jiāmǎ
加盟	jiāméng
加片兒	jiāpiànr
加薪	jiāxīn
加油	jiāyóu
夾道	jiādào
夾擊	jiājī
佳節	jiājié
*佳肴	jiāyáo
佳作	jiāzuò
*家常	jiācháng
家常菜	jiāchángcài
家傳	jiāchuán
家當兒	jiā·dàngr
家計	jiājì
家教	jiājiào
家境	jiājìng
*家居	jiājū
家眷	jiājuàn
家門	jiāmén
*家禽	jiāqín
家事	jiāshì
家書	jiāshū
家喻戶曉	jiāyùhùxiǎo
家園	jiāyuán
嘉	jiā
*嘉賓	jiābīn
嘉許	jiāxŭ
頰	jiá
甲骨文	jiǎgŭwén
假貨	jiǎhuò
假借	jiǎjiè
假象	jiǎxiàng
架次	jiàcì
*架構	jiàgòu
架空	jiàkōng
架勢	jià·shi
駕	jià
駕臨	jiàlín
駕輕就熟	jiàqīngjiùshú
駕馭	jiàyù
*假日	jiàrì
嫁妝	jià·zhuang
價廉物美	jiàliánwùmĕi
價碼	jiàmǎ
價目	jiàmù
*價值觀	jiàzhíguān
奸	jiān
尖端	jiānduān
尖叫	jiānjiào
*肩負	jiānfù
*兼備	jiānbèi
兼併	jiānbìng
*兼顧	jiāngù
兼職	jiānzhí
堅	jiān
堅忍	jiānrĕn
堅毅	jiānyì
堅貞	jiānzhēn
*煎	jiān
煎熬	jiān'áo
煎餅	jiān·bing
監	jiān
*監測	jiāncè
*監察	jiānchá
*監管	jiānguǎn
監護人	jiānhùrén
*監禁	jiānjìn
*監控	jiānkòng
監理	jiānlǐ
*監製	jiānzhì
緘默	jiānmò
艱深	jiānshēn
艱辛	jiānxīn
殲	jiān
柬	jiǎn
揀選	jiǎnxuǎn
剪報	jiǎnbào
剪裁	jiǎncái
剪輯	jiǎnjí
剪接	jiǎnjiē
剪影	jiǎnyǐng
*減肥	jiǎnféi
減幅	jiǎnfú
減縮	jiǎnsuō
減削	jiǎnxuē
減壓	jiǎnyā
*檢測	jiǎncè
檢察	jiǎnchá
*檢察官	jiǎncháguān
檢點	jiǎndiǎn
檢定	jiǎndìng
*檢視	jiǎnshì
檢索	jiǎnsuŏ
*檢疫	jiǎnyì
檢閱	jiǎnyuè
簡報	jiǎnbào
*簡便	jiǎnbiàn
*簡潔	jiǎnjié
*簡介	jiǎnjiè
簡歷	jiǎnlì
簡略	jiǎnlüè
簡樸	jiǎnpŭ
簡述	jiǎnshù
簡訊	jiǎnxùn
*簡易	jiǎnyì
簡約	jiǎnyuē
鹼性	jiǎnxìng
見仁見智	jiànrénjiànzhì
見死不救	jiànsǐbùjiù
見聞	jiànwén
見習	jiànxí
見效	jiànxiào
*見證	jiànzhèng
建材	jiàncái
*建構	jiàngòu
建樹	jiànshù
*建築師	jiànzhùshī
*建築物	jiànzhùwù
健兒	jiàn'ér
健身	jiànshēn
健碩	jiànshuò
毽子	jiàn·zi
*鍵盤	jiànpán
間諜	jiàndié
間斷	jiànduàn
間或	jiànhuò
間歇	jiànxiē
*漸趨	jiànqū
箭頭	jiàntóu
賤	jiàn
賤賣	jiànmài
餞行	jiànxíng
薦	jiàn
艦	jiàn
艦隊	jiànduì
鑒賞	jiànshǎng
鑒證	jiànzhèng
*江湖	jiānghú
江山	jiāngshān
將功補過	jiānggōngbŭguò
將就	jiāng·jiu
僵	jiāng
僵持	jiāngchí
僵化	jiānghuà
僵硬	jiāngyìng
薑	jiāng
疆	jiāng
疆土	jiāngtŭ
*獎項	jiǎngxiàng
*獎牌	jiǎngpái
獎券	jiǎngquàn
*獎賞	jiǎngshǎng
獎章	jiǎngzhāng
*講解	jiǎngjiĕ
*講求	jiǎngqiú
講師	jiǎngshī
講授	jiǎngshòu
*講座	jiǎngzuò
匠	jiàng
將領	jiànglǐng
醬	jiàng
*醬汁	jiàngzhī
降溫	jiàngwēn
降雪	jiàngxuĕ
降雨	jiàngyŭ
交白卷	jiāobáijuàn
交差	jiāochāi
交待	jiāodài
交鋒	jiāofēng
*交付	jiāofù
*交匯	jiāohuì
交接	jiāojiē
*交界	jiāojiè
交流會	jiāoliúhuì
交融	jiāoróng
交響樂	jiāoxiǎngyuè
交易額	jiāoyì'é
*交易所	jiāoyìsuŏ
郊	jiāo
郊外	jiāowài
*郊野	jiāoyĕ
郊遊	jiāoyóu
教書	jiāoshū
椒	jiāo
椒鹽	jiāoyán
*焦慮	jiāolǜ
焦油	jiāoyóu
焦躁	jiāozào
礁	jiāo
膠水	jiāoshuǐ
膠質	jiāozhì
嬌	jiāo
嬌艷	jiāoyàn
嬌縱	jiāozòng
驕人	jiāorén
佼佼者	jiǎojiǎozhĕ
絞	jiǎo
絞盡腦汁	jiǎojìnnǎozhī
角膜	jiǎomó
腳板	jiǎobǎn
腳法	jiǎofǎ
腳跟	jiǎogēn
腳踝	jiǎohuái
腳尖	jiǎojiān
腳踏實地	jiǎotàshídì
腳掌	jiǎozhǎng
腳趾	jiǎozhǐ
僥幸	jiǎoxìng
矯	jiǎo
矯健	jiǎojiàn
矯飾	jiǎoshì
矯枉過正	jiǎowǎngguòzhèng
矯正	jiǎozhèng
繳	jiǎo
*繳費	jiǎofèi
*繳付	jiǎofù
繳稅	jiǎoshuì
*攪拌	jiǎobàn
攪拌機	jiǎobànjī
攪和	jiǎo·huo
叫好	jiàohǎo
叫化子	jiàohuā·zi
校對	jiàoduì
教案	jiào'àn
教父	jiàofù
*教改	jiàogǎi
教化	jiàohuà
教皇	Jiàohuáng
教誨	jiàohuì
教科書	jiàokēshū
教派	jiàopài
教廷	Jiàotíng
教徒	jiàotú
教學法	jiàoxuéfǎ
教研	jiàoyán
教友	jiàoyŏu
教育家	jiàoyùjiā
教職	jiàozhí
教宗	Jiàozōng
轎	jiào
醮	jiào
接班	jiēbān
接二連三	jiē'èrliánsān
*接管	jiēguǎn
接軌	jiēguǐ
接合	jiēhé
*接獲	jiēhuò
接力	jiēlì
*接納	jiēnà
接壤	jiērǎng
接任	jiērèn
接手	jiēshŏu
接送	jiēsòng
接替	jiētì
接吻	jiēwĕn
接線	jiēxiàn
接線生	jiēxiànshēng
接續	jiēxù
接應	jiēyìng
接踵	jiēzhŏng
接種	jiēzhòng
揭	jiē
*揭幕	jiēmù
揭曉	jiēxiǎo
街燈	jiēdēng
街景	jiējǐng
*街市	jiēshì
階	jiē
階梯	jiētī
劫	jié
劫案	jié'àn
劫後餘生	jiéhòuyúshēng
劫數	jiéshù
桔梗	jiégĕng
結案	jié'àn
結拜	jiébài
結伴	jiébàn
結存	jiécún
結核	jiéhé
結集	jiéjí
結盟	jiéméng
結社	jiéshè
結識	jiéshí
*結業	jiéyè
*結餘	jiéyú
結語	jiéyŭ
結賬	jiézhàng
捷	jié
捷足先登	jiézúxiāndēng
睫毛	jiémáo
節儉	jiéjiǎn
節流	jiéliú
節拍	jiépāi
節食	jiéshí
節外生枝	jiéwàishēngzhī
節選	jiéxuǎn
節制	jiézhì
*截斷	jiéduàn
截稿	jiégǎo
截獲	jiéhuò
截擊	jiéjī
截然	jiérán
*截止	jiézhǐ
截至	jiézhì
竭	jié
竭盡	jiéjìn
潔	jié
潔淨	jiéjìng
解凍	jiĕdòng
解讀	jiĕdú
*解僱	jiěgù
解禁	jiĕjìn
解救	jiĕjiù
解開	jiĕkāi
解悶	jiĕmèn
解難	jiĕnàn
解說	jiĕshuō
解體	jiĕtǐ
解約	jiĕyuē
介	jiè
*介入	jièrù
*介意	jièyì
戒備	jièbèi
戒除	jièchú
戒毒	jièdú
戒毒所	jièdúsuŏ
戒心	jièxīn
*戒煙	jièyān
戒指	jiè·zhi
*屆滿	jièmǎn
*屆時	jièshí
*界定	jièdìng
借貸	jièdài
借調	jièdiào
借書	jièshū
借書證	jièshūzhèng
借題發揮	jiètífāhuī
借閱	jièyuè
藉	jiè
*藉以	jièyǐ
巾	jīn
今非昔比	jīnfēixībǐ
金榜	jīnbǎng
金碧輝煌	jīnbìhuīhuáng
金箔	jīnbó
金剛	Jīngāng
金黃	jīnhuáng
*金卡	jīnkǎ
金礦	jīnkuàng
金器	jīnqì
金色	jīnsè
金飾	jīnshì
金像獎	Jīnxiàngjiǎng
金枝玉葉	jīnzhīyùyè
金字塔	jīnzìtǎ
*金子	jīn·zi
津津樂道	jīnjīnlèdào
津津有味	jīnjīnyŏuwèi
*津貼	jīntiē
筋	jīn
筋骨	jīngŭ
禁	jīn
襟	jīn
緊閉	jǐnbì
緊湊	jǐncòu
緊要	jǐnyào
錦	jǐn
錦標	jǐnbiāo
錦鯉	jǐnlǐ
錦囊	jǐnnáng
錦上添花	jǐnshàngtiānhuā
*儘早	jǐnzǎo
謹	jǐn
謹防	jǐnfáng
謹記	jǐnjì
近況	jìnkuàng
*近期	jìnqī
近親	jìnqīn
近視	jìn·shì
勁歌	jìnggē
晉級	jìnjí
*浸泡	jìnpào
浸透	jìntòu
*進出	jìnchū
*進出口	jìnchūkŏu
*進度	jìndù
進發	jìnfā
進貢	jìngòng
進口商	jìnkŏushāng
進食	jìnshí
進行曲	jìnxíngqŭ
進賬	jìnzhàng
進駐	jìnzhù
禁	jìn
禁忌	jìnjì
禁令	jìnlìng
禁煙	jìnyān
禁運	jìnyùn
*盡情	jìnqíng
盡善盡美	jìnshànjìnmĕi
盡收眼底	jìnshōuyǎndǐ
盡頭	jìntóu
盡現	jìnxiàn
盡力	jìnlì
盡興	jìnxìng
盡責	jìnzé
盡職	jìnzhí
盡忠	jìnzhōng
京城	jīngchéng
京師	jīngshī
荊	jīng
荊棘	jīngjí
*晶片	jīngpiàn
晶瑩	jīngyíng
睛	jīng
*精彩	jīngcǎi
精粹	jīngcuì
精打細算	jīngdǎxìsuàn
精讀	jīngdú
精煉	jīngliàn
精良	jīngliáng
*精美	jīngmĕi
精妙	jīngmiào
*精明	jīngmíng
精疲力竭	jīngpílìjié
精闢	jīngpì
*精品	jīngpǐn
精巧	jīngqiǎo
精銳	jīngruì
精神病	jīngshénbìng
精髓	jīngsuǐ
*精選	jīngxuǎn
精要	jīngyào
精益求精	jīngyìqiújīng
*精英	jīngyīng
*精湛	jīngzhàn
精忠	jīngzhōng
精裝	jīngzhuāng
經不起	jīng·bùqǐ
經得起	jīng·déqǐ
*經紀	jīngjì
經濟學	jīngjìxué
*經貿	jīngmào
經年累月	jīngniánlĕiyuè
經銷	jīngxiāo
經銷商	jīngxiāoshāng
經文	jīngwén
*經由	jīngyóu
驚愕	jīng'è
驚呼	jīnghū
驚惶	jīnghuáng
驚覺	jīngjué
驚嘆	jīngtàn
驚險	jīngxiǎn
驚心動魄	jīngxīndòngpò
井井有條	jǐngjǐngyŏutiáo
*景點	jǐngdiǎn
*景觀	jǐngguān
景況	jǐngkuàng
*景致	jǐngzhì
警	jǐng
警報	jǐngbào
警車	jǐngchē
警方	jǐngfāng
警號	jǐnghào
*警覺	jǐngjué
警示	jǐngshì
*警署	jǐngshŭ
警訊	jǐngxùn
警鐘	jǐngzhōng
勁敵	jìngdí
勁旅	jìnglǚ
痙攣	jìngluán
淨額	jìng'é
淨化器	jìnghuàqì
*淨值	jìngzhí
靜電	jìngdiàn
靜悄悄	jìngqiāoqiāo
靜態	jìngtài
靜坐	jìngzuò
敬佩	jìngpèi
敬畏	jìngwèi
敬仰	jìngyǎng
敬業	jìngyè
敬意	jìngyì
敬重	jìngzhòng
靚	jìng
鏡片	jìngpiàn
競	jìng
競技	jìngjì
*競爭力	jìngzhēnglì
競逐	jìngzhú
迥然	jiŏngrán
窘	jiŏng
糾	jiū
糾察	jiūchá
糾纏	jiūchán
久違	jiŭwéi
灸	jiŭ
韭菜	jiŭcài
*酒吧	jiŭbā
酒杯	jiŭbēi
*酒店	jiŭdiàn
酒館	jiŭguǎn
酒家	jiŭjiā
*酒樓	jiŭlóu
酒瓶	jiŭpíng
酒窩	jiŭwō
救護	jiùhù
救護車	jiùhùchē
救命	jiùmìng
救生員	jiùshēngyuán
救贖	jiùshú
救亡	jiùwáng
*救援	jiùyuán
救治	jiùzhì
*就此	jiùcǐ
就地	jiùdì
*就讀	jiùdú
就範	jiùfàn
就教	jiùjiào
就寢	jiùqǐn
就緒	jiùxù
就學	jiùxué
就醫	jiùyī
就診	jiùzhĕn
舅父	jiùfù
舅媽	jiùmā
舊日	jiùrì
舊時	jiùshí
居安思危	jū'ānsīwēi
居高臨下	jūgāolínxià
居留	jūliú
*居留權	jūliúquán
*居士	jūshì
*居所	jūsuŏ
居屋	jūwū
拘	jū
*拘捕	jūbŭ
拘謹	jūjǐn
拘泥	jūnì
狙擊	jūjī
鞠躬	jūgōng
桔	jú
焗	jú
跼促	júcù
菊	jú
沮喪	jŭsàng
矩	jŭ
*舉報	jŭbào
舉措	jŭcuò
舉家	jŭjiā
*舉例	jŭlì
舉世	jŭshì
舉手	jŭshŏu
舉手之勞	jŭshŏuzhīláo
舉一反三	jŭyīfǎnsān
舉債	jŭzhài
*舉證	jŭzhèng
舉止	jŭzhǐ
*舉足輕重	jŭzúqīngzhòng
巨變	jùbiàn
巨匠	jùjiàng
巨款	jùkuǎn
巨浪	jùlàng
巨人	jùrén
巨頭	jùtóu
巨響	jùxiǎng
*巨星	jùxīng
*巨型	jùxíng
巨著	jùzhù
拒	jù
鉅資	jùzī
句法	jùfǎ
句號	jùhào
句式	jùshì
俱備	jùbèi
俱全	jùquán
颶風	jùfēng
聚合	jùhé
*聚會	jùhuì
聚焦	jùjiāo
聚精會神	jùjīnghuìshén
*聚居	jùjū
聚散	jùsàn
劇評	jùpíng
*劇情	jùqíng
劇壇	jùtán
*劇院	jùyuàn
劇增	jùzēng
劇照	jùzhào
劇作	jùzuò
據理力爭	jùlǐlìzhēng
*據悉	jùxī
踞	jù
鋸	jù
鋸齒	jùchǐ
懼	jù
懼怕	jùpà
*捐款	juānkuǎn
捐錢	juānqián
*捐贈	juānzèng
捐助	juānzhù
娟秀	juānxiù
捲縮	juǎnsuō
捲曲	juǎnqū
捲土重來	juǎntŭchónglái
卷軸	juànzhóu
倦	juàn
眷顧	juàngù
眷戀	juànliàn
雋永	juànyŏng
角力	juélì
角逐	juézhú
決鬥	juédòu
決斷	juéduàn
決裂	juéliè
*決賽	juésài
決意	juéyì
*抉擇	juézé
訣	jué
訣別	juébié
倔強	juéjiàng
掘	jué
崛起	juéqǐ
厥	jué
絕活	juéhuó
絕技	juéjì
絕跡	juéjì
絕口	juékŏu
絕路	juélù
絕倫	juélún
絕情	juéqíng
絕色	juésè
絕食	juéshí
絕世	juéshì
絕無僅有	juéwújǐnyŏu
絕招	juézhāo
絕症	juézhèng
絕種	juézhŏng
爵	jué
*爵士	juéshì
爵士樂	juéshìyuè
倔	juè
君臨	jūnlín
君子	jūnzǐ
軍方	jūnfāng
軍費	jūnfèi
軍器	jūnqì
軍團	jūntuán
軍械	jūnxiè
軍營	jūnyíng
鈞	jūn
峻	jùn
峻峭	jùnqiào
*竣工	jùngōng
駿馬	jùnmǎ
咖啡因	kāfēiyīn
*卡路里	kǎlùlǐ
*卡通	kǎtōng
卡通片	kǎtōngpiàn
揩	kāi
揩油	kāiyóu
開場	kāichǎng
開場白	kāichǎngbái
開端	kāiduān
開發商	kāifāshāng
開懷	kāihuái
開解	kāijiĕ
開掘	kāijué
開朗	kāilǎng
開鑼	kāiluó
開盤	kāipán
開啟	kāiqǐ
開腔	kāiqiāng
開槍	kāiqiāng
開竅	kāiqiào
開賽	kāisài
開審	kāishĕn
開首	kāishŏu
開庭	kāitíng
開通	kāitōng
開銷	kāi·xiāo
*開心	kāixīn
開心果	kāixīnguŏ
開演	kāiyǎn
*開業	kāiyè
開鑿	kāizáo
開張	kāizhāng
開徵	kāizhēng
開宗明義	kāizōngmíngyì
楷模	kǎimó
慨嘆	kǎitàn
刊	kān
刊發	kānfā
刊行	kānxíng
刊載	kānzǎi
看管	kānguǎn
看護	kānhù
看守	kānshŏu
勘測	kāncè
勘查	kānchá
勘察	kānchá
堪	kān
坎	kǎn
坎坷	kǎnkĕ
砍柴	kǎnchái
砍伐	kǎnfá
看病	kànbìng
看穿	kànchuān
看顧	kàngù
*看好	kànhǎo
看客	kànkè
看破	kànpò
看齊	kànqí
看台	kàntái
看中	kànzhòng
看準	kànzhŭn
康	kāng
*康復	kāngfù
*康樂	kānglè
康泰	kāngtài
亢奮	kàngfèn
*抗辯	kàngbiàn
抗衡	kànghéng
*抗拒	kàngjù
抗菌	kàngjūn
抗生素	kàngshēngsù
抗體	kàngtǐ
抗藥性	kàngyàoxìng
抗爭	kàngzhēng
考場	kǎochǎng
考古學	kǎogŭxué
考績	kǎojì
考究	kǎo·jiu
考據	kǎojù
考卷	kǎojuàn
考評	kǎopíng
考勤	kǎoqín
*考生	kǎoshēng
考證	kǎozhèng
拷貝	kǎobèi
烤	kǎo
烤爐	kǎolú
烤肉	kǎoròu
苛刻	kēkè
柯	kē
科幻	kēhuàn
科舉	kējŭ
*科目	kēmù
科學館	kēxuéguǎn
瞌睡	kēshuì
可悲	kĕbēi
可否	kĕfŏu
*可觀	kĕguān
*可口	kĕkŏu
可樂	kĕlè
可親	kĕqīn
可人	kĕrén
可信	kĕxìn
*可行	kĕxíng
*可疑	kĕyí
渴	kĕ
渴求	kĕqiú
克制	kèzhì
剋星	kèxīng
刻板	kèbǎn
刻不容緩	kèbùrónghuǎn
刻骨銘心	kègŭmíngxīn
*刻意	kèyì
客船	kèchuán
客串	kèchuàn
*客戶	kèhù
*客機	kèjī
客輪	kèlún
客源	kèyuán
*客運	kèyùn
客棧	kèzhàn
恪守	kèshŏu
*課室	kèshì
*課稅	kèshuì
課外	kèwài
*課餘	kèyú
墾	kĕn
坑人	kēngrén
鏗鏘	kēngqiāng
空蕩蕩	kōngdàngdàng
空泛	kōngfàn
空姐	kōngjiĕ
空曠	kōngkuàng
*空調	kōngtiáo
空頭	kōngtóu
空郵	kōngyóu
*空運	kōngyùn
孔教	Kŏngjiào
孔廟	Kŏngmiào
恐	kŏng
恐嚇	kŏnghè
恐龍	kŏnglóng
空地	kòngdì
*空缺	kòngquē
空位	kòngwèi
空閒	kòngxián
控	kòng
控告	kònggào
*控股	kònggŭ
摳	kōu
摳字眼兒	kōuzìyǎnr
*口岸	kŏu'àn
口碑	kŏubēi
口風琴	kŏufēngqín
口福	kŏufú
口腹	kŏufù
*口感	kŏugǎn
口供	kŏugòng
口紅	kŏuhóng
口角	kŏujiǎo
口訣	kŏujué
口渴	kŏukĕ
口琴	kŏuqín
口哨	kŏushào
口述	kŏushù
口水	kŏushuǐ
*口味	kŏuwèi
口吻	kŏuwĕn
口香糖	kŏuxiāngtáng
口型	kŏuxíng
口音	kŏuyīn
*口罩	kŏuzhào
口誅筆伐	kŏuzhūbǐfá
*扣除	kòuchú
扣留	kòuliú
扣人心弦	kòurénxīnxián
*扣押	kòuyā
叩	kòu
叩頭	kòutóu
枯	kū
枯黃	kūhuáng
枯枝	kūzhī
哭泣	kūqì
哭訴	kūsù
哭笑不得	kūxiàobùdé
窟	kū
苦不堪言	kŭbùkānyán
苦楚	kŭchŭ
苦功	kŭgōng
苦瓜	kŭguā
苦練	kŭliàn
苦戀	kŭliàn
苦悶	kŭmèn
苦命	kŭmìng
苦澀	kŭsè
苦痛	kŭtòng
苦味	kŭwèi
苦笑	kŭxiào
苦戰	kŭzhàn
苦衷	kŭzhōng
酷	kù
酷愛	kù'ài
酷熱	kùrè
酷暑	kùshŭ
酷刑	kùxíng
褲	kù
褲襠	kùdāng
褲管	kùguǎn
誇	kuā
誇大	kuādà
誇耀	kuāyào
誇讚	kuāzàn
垮臺	kuǎtái
跨過	kuàguò
*跨越	kuàyuè
快餐	kuàicān
快遞	kuàidì
*快捷	kuàijié
快門	kuàimén
快艇	kuàitǐng
快意	kuàiyì
*會計師	kuàijìshī
膾炙人口	kuàizhìrénkŏu
寬度	kuāndù
*寬頻	kuānpín
寬容	kuānróng
寬恕	kuānshù
*寬鬆	kuānsōng
寬限	kuānxiàn
寬裕	kuānyù
*款額	kuǎn'é
*款式	kuǎnshì
*款項	kuǎnxiàng
誆人	kuāngrén
狂暴	kuángbào
狂放	kuángfàng
狂歡	kuánghuān
狂亂	kuángluàn
狂犬病	kuángquǎnbìng
狂熱	kuángrè
狂妄	kuángwàng
狂想	kuángxiǎng
狂野	kuángyĕ
況	kuàng
框	kuàng
*框架	kuàngjià
眶	kuàng
曠	kuàng
曠世	kuàngshì
曠野	kuàngyĕ
礦場	kuàngchǎng
礦工	kuànggōng
礦泉水	kuàngquánshuǐ
*礦物質	kuàngwùzhì
窺	kuī
窺看	kuīkàn
窺視	kuīshì
窺探	kuītàn
虧本	kuībĕn
虧欠	kuīqiàn
愧	kuì
匱乏	kuìfá
潰	kuì
潰瘍	kuìyáng
饋贈	kuìzèng
坤	kūn
困頓	kùndùn
困惑	kùnhuò
困窘	kùnjiŏng
*困擾	kùnrǎo
睏倦	kùnjuàn
括	kuò
廓	kuò
闊別	kuòbié
闊綽	kuòchuò
擴	kuò
*擴充	kuòchōng
*擴建	kuòjiàn
擴音器	kuòyīnqì
拉扯	lā·che
拉丁舞	lādīngwŭ
拉麵	lāmiàn
垃圾	lājī
垃圾桶	lājītŏng
喇嘛	lǎ·ma
辣	là
辣椒	làjiāo
辣醬	làjiàng
臘	là
臘腸	làcháng
臘味	làwèi
蠟像	làxiàng
來函	láihán
來龍去脈	láilóngqùmài
來勢	láishì
賴以	làiyǐ
藍本	lánbĕn
藍籌股	lánchóugŭ
*藍圖	lántú
籃	lán
籃板	lánbǎn
籃球	lánqiú
攔	lán
攔截	lánjié
懶	lǎn
懶得	lǎn·dé
懶散	lǎnsǎn
懶洋洋	lǎnyāngyāng
覽	lǎn
攬	lǎn
纜	lǎn
*纜車	lǎnchē
濫	làn
*濫用	lànyòng
狼吞虎咽	lángtūnhŭyān
郎	láng
廊	láng
*朗誦	lǎngsòng
*浪漫	làngmàn
浪子	làngzǐ
牢籠	láolóng
勞累	láolèi
*勞工	láogōng
勞駕	láojià
勞苦	láokŭ
勞碌	láolù
勞損	láosŭn
勞心	láoxīn
*勞資	láozī
嘮叨	láo·dao
老闆娘	lǎobǎnniáng
老成	lǎochéng
老婦	lǎofù
老將	lǎojiàng
老年人	lǎoniánrén
老牌	lǎopái
老少	lǎoshào
老少咸宜	lǎoshàoxiányí
老式	lǎoshì
老頭兒	lǎotóur
姥姥	lǎo·lao
姥爺	lǎo·ye
烙	lào
烙印	làoyìn
勒	lè
勒令	lèlìng
勒索	lèsuŏ
樂此不疲	lècǐbùpí
樂而忘返	lè'érwàngfǎn
*樂趣	lèqù
樂善好施	lèshànhàoshī
樂陶陶	lètáotáo
樂天	lètiān
*樂意	lèyì
*樂園	lèyuán
勒	lēi
累贅	léi·zhui
雷暴	léibào
雷動	léidòng
雷霆萬鈞	léitíngwànjūn
雷同	léitóng
擂	léi
鐳	léi
鐳射	léishè
磊落	lĕiluò
壘	lĕi
壘球	lĕiqiú
纍積	lĕijī
肋	lèi
肋骨	lèigŭ
淚光	lèiguāng
淚如雨下	lèirúyŭxià
淚眼	lèiyǎn
淚珠	lèizhū
擂	lèi
類別	lèibié
棱	léng
棱角	léngjiǎo
冷不防	lĕng·bufáng
*冷藏	lĕngcáng
冷凍	lĕngdòng
冷酷	lĕngkù
冷落	lĕngluò
冷門	lĕngmén
冷漠	lĕngmò
冷凝	lĕngníng
冷盤	lĕngpán
冷氣	lĕngqì
冷清	lĕng·qīng
冷戰	lĕngzhàn
*厘米	límǐ
梨花	líhuā
蒞臨	lìlín
黎民	límín
*黎明	límíng
罹患	líhuàn
離愁	líchóu
離譜	lípŭ
離奇	líqí
離棄	líqì
離任	lírèn
離散	lísàn
離世	líshì
離職	lízhí
李子	lǐ·zi
*里程	lǐchéng
里程碑	lǐchéngbēi
*理財	lǐcái
*理科	lǐkē
*理念	lǐniàn
理事	lǐ·shì
理所當然	lǐsuŏdāngrán
鯉	lǐ
*鯉魚	lǐyú
禮服	lǐfú
禮器	lǐqì
禮券	lǐquàn
禮讓	lǐràng
禮堂	lǐtáng
禮儀	lǐyí
禮遇	lǐyù
禮制	lǐzhì
力不從心	lìbùcóngxīn
力挫	lìcuò
*力度	lìdù
力爭	lìzhēng
*立法會	lìfǎhuì
立交	lìjiāo
立時	lìshí
立約	lìyuē
立志	lìzhì
立足	lìzú
吏	lì
利弊	lìbì
利落	lì·luo
利器	lìqì
例規	lìguī
例會	lìhuì
例行	lìxíng
例證	lìzhèng
*荔枝	lìzhī
曆法	lìfǎ
*歷程	lìchéng
歷屆	lìjiè
歷經	lìjīng
歷久不衰	lìjiŭbùshuāi
歷練	lìliàn
歷任	lìrèn
歷時	lìshí
歷史性	lìshǐxìng
歷險	lìxiǎn
勵志	lìzhì
隸	lì
隸書	lìshū
*隸屬	lìshŭ
連串	liánchuàn
連帶	liándài
連貫	liánguàn
連環	liánhuán
連環畫	liánhuánhuà
連襟	liánjīn
連累	lián·lĕi
連袂	liánmèi
連鎖	liánsuŏ
連夜	liányè
蓮	lián
蓮花	liánhuā
漣漪	liányī
廉	lián
*廉署	liánshŭ
*聯賽	liánsài
*聯手	liánshŏu
*聯網	liánwǎng
聯校	liánxiào
聯誼	liányì
聯運	liányùn
斂	liǎn
臉蛋	liǎndàn
臉頰	liǎnjiá
臉孔	liǎnkŏng
臉龐	liǎnpáng
臉譜	liǎnpŭ
煉油	liànyóu
練功	liàngōng
*殮房	liànfáng
戀	liàn
戀情	liànqíng
戀人	liànrén
*良機	liángjī
良性	liángxìng
良莠不齊	liángyŏubùqí
良知	liángzhī
涼茶	liángchá
涼粉	liángfĕn
涼快	liáng·kuai
涼爽	liángshuǎng
涼亭	liángtíng
涼鞋	liángxié
*量度	liángdù
糧草	liángcǎo
兩面	liǎngmiàn
兩訖	liǎngqì
亮麗	liànglì
亮相	liàngxiàng
量化	liànghuà
量入為出	liàngrùwéichū
量刑	liàngxíng
晾	liàng
晾曬	liàngshài
踉蹌	liàngqiàng
聊	liáo
聊天兒	liáotiānr
寥寥可數	liáoliáokĕshŭ
寥落	liáoluò
嘹亮	liáoliàng
寮屋	liáowū
潦倒	liáodǎo
遼	liáo
療	liáo
療程	liáochéng
療法	liáofǎ
療傷	liáoshāng
療養	liáoyǎng
療養院	liáoyǎngyuàn
繚繞	liáorào
了結	liǎojié
了事	liǎoshì
瞭若指掌	liǎoruòzhǐzhǎng
料到	liàodào
*料理	liàolǐ
料想	liàoxiǎng
劣	liè
劣質	lièzhì
列表	lièbiǎo
列強	lièqiáng
列印	lièyìn
烈	liè
烈日	lièrì
烈焰	lièyàn
裂縫	lièfèng
裂痕	lièhén
獵殺	lièshā
獵物	lièwù
林地	líndì
*林立	línlì
淋漓	línlí
淋漓盡致	línlíjìnzhì
淋浴	línyù
琳瑯滿目	línlángmǎnmù
嶙峋	línxún
遴選	línxuǎn
鄰舍	línshè
鱗	lín
臨別	línbié
臨場	línchǎng
臨摹	línmó
臨時工	línshígōng
臨危不亂	línwēibùluàn
臨終	línzhōng
凜冽	lǐnliè
凜然	lǐnrán
吝嗇	lìnsè
伶	líng
伶仃	língdīng
伶人	língrén
伶牙俐齒	língyálìchǐ
羚羊	língyáng
*聆聽	língtīng
聆訊	língxùn
鈴聲	língshēng
凌	líng
*凌晨	língchén
凌駕	língjià
凌空	língkōng
凌厲	línglì
凌亂	língluàn
陵	líng
陵墓	língmù
陵園	língyuán
零點	língdiǎn
零度	língdù
零賣	língmài
零散	língsǎn
零食	lingshí
零下	língxià
零用錢	língyòngqián
靈光	língguāng
靈機	língjī
靈氣	língqì
靈位	língwèi
靈性	língxìng
靈驗	lingyàn
靈芝	língzhī
領帶	lǐngdài
*領隊	lǐngduì
領航	lǐngháng
領教	lǐngjiào
領軍	lǐngjūn
*領略	lǐnglüè
*領取	lǐngqŭ
領事館	lǐngshìguǎn
領悟	lǐngwù
*領先	lǐngxiān
領養	lǐngyǎng
另闢蹊徑	lìngbìxījìng
溜冰	liūbīng
流產	liúchǎn
流暢	liúchàng
*流程	liúchéng
流放	liúfàng
*流感	liúgǎn
*流浪	liúlàng
流浪漢	liúlànghàn
流淚	liúlèi
流離失所	liúlíshīsuŏ
流連	liúlián
*流量	liúliàng
流落	liúluò
*流失	liúshī
流逝	liúshì
流水賬	liúshuǐzhàng
流淌	liútǎng
流亡	liúwáng
流星	liúxīng
流星雨	liúxīngyŭ
流行病	liúxíngbìng
流質	liúzhì
流轉	liúzhuǎn
留存	liúcún
留待	liúdài
留話	liúhuà
留難	liúnàn
留任	liúrèn
留守	liúshŏu
留宿	liúsù
留心	liúxīn
留言	liúyán
*留意	liúyì
榴槤	liúlián
瀏覽	liúlǎn
六合彩	liùhécǎi
龍鳳	lóngfèng
龍井	lóngjǐng
龍捲風	lóngjuǎnfēng
*龍門	lóngmén
*龍頭	lóngtóu
*龍蝦	lóngxiā
*龍舟	lóngzhōu
聾	lóng
壟	lŏng
隴	Lŏng
樓花	lóuhuā
*樓市	lóushì
陋	lòu
陋室	lòushì
陋習	lòuxí
漏洞	lòudòng
漏水	lòushuǐ
*蘆筍	lúsŭn
爐火	lúhuŏ
魯莽	lŭmǎng
虜	lŭ
*陸路	lùlù
鹿茸	lùróng
路標	lùbiāo
路燈	lùdēng
*路段	lùduàn
*路軌	lùguǐ
路徑	lùjìng
*路面	lùmiàn
路牌	lùpái
路人	lùrén
路途	lùtú
錄音	lùyīn
錄音帶	lùyīndài
錄製	lùzhì
戮力	lùlì
露骨	lùgŭ
露水	lù·shuǐ
露宿	lùsù
*露台	lùtái
*露天	lùtiān
露營	lùyíng
*旅程	lǚchéng
旅社	lǚshè
旅舍	lǚshè
*旅行社	lǚxíngshè
*旅行團	lǚxíngtuán
旅遊車	lǚyóuchē
旅遊局	lǚyóujú
履	lǚ
履歷	lǚlì
履約	lǚyuē
*律政司	lǜzhèngsī
慮	lǜ
綠燈	lǜdēng
綠豆	lǜdòu
綠葉	lǜyè
綠油油	lǜyōuyōu
綠洲	lǜzhōu
孿	luán
孿生	luánshēng
亂倫	luànlún
亂七八糟	luànqībāzāo
掠	lüè
掠影	lüèyǐng
略勝一籌	lüèshèngyīchóu
淪落	lúnluò
淪陷	lúnxiàn
輪班	lúnbān
輪胎	lúntāi
*輪椅	lúnyǐ
論辯	lùnbiàn
論據	lùnjù
論說	lùnshuō
*論壇	lùntán
論題	lùntí
螺	luó
螺絲	luósī
蘿蔔	luó·bo
蘿蔔糕	luó·bogāo
鑼	luó
鑼鼓	luógŭ
裸	luŏ
落筆	luòbǐ
*落成	luòchéng
落地生根	luòdìshēnggēn
落腳	luòjiǎo
落空	luòkōng
落淚	luòlèi
*落馬	luòmǎ
落寞	luòmò
落葉	luòyè
絡繹	luòyì
麻辣	málà
麻將	májiàng
麻疹	mázhĕn
麻醉藥	mázuìyào
馬不停蹄	mǎbùtíngtí
*馬場	mǎchǎng
*馬拉松	mǎlāsōng
馬匹	mǎpǐ
馬術	mǎshù
馬桶	mǎtŏng
埋藏	máicáng
埋伏	mái·fú
埋葬	máizàng
買菜	mǎicài
買家	mǎijiā
脈絡	màiluò
脈象	màixiàng
麥芽糖	màiyátáng
*賣點	màidiǎn
賣關子	màiguān·zi
賣家	màijiā
賣力	màilì
賣弄	mài·nong
*賣相	màixiàng
賣座	màizuò
邁步	màibù
邁進	màijìn
鰻	mán
鰻魚	mányú
滿分	mǎnfēn
滿目	mǎnmù
滿天	mǎntiān
滿載	mǎnzài
滿座	mǎnzuò
慢吞吞	màntūntūn
慢悠悠	mànyōuyōu
漫	màn
漫不經心	mànbùjīngxīn
*漫步	mànbù
*漫畫	mànhuà
漫天	màntiān
漫遊	mànyóu
芒果	mángguŏ
盲	máng
盲點	mángdiǎn
莽撞	mǎngzhuàng
*貓頭鷹	māotóuyīng
毛筆	máobǐ
毛豆	máodòu
毛髮	máofà
毛猴	máohóu
毛孔	máokŏng
毛利	máolì
毛毛雨	máo·maoyŭ
毛皮	máopí
矛	máo
矛頭	máotóu
錨	máo
冒充	màochōng
冒犯	màofàn
冒牌貨	màopáihuò
冒失	mào·shi
貿然	màorán
貌	mào
沒關係	méiguān·xi
沒好氣	méihǎoqì
沒趣	méiqù
沒完沒了	méiwánméiliǎo
沒準兒	méizhŭnr
*玫瑰	méi·gui
眉目	méimù
眉梢	méishāo
眉宇	méiyŭ
梅	méi
梅開二度	méikāi'èrdù
梅子	méi·zi
霉	méi
媒	méi
*媒體	méitǐ
煤礦	méikuàng
煤油	méiyóu
*每逢	mĕiféng
美不勝收	mĕibùshèngshōu
美稱	mĕichēng
*美景	mĕijǐng
美酒	mĕijiŭ
美侖美奐	mĕilúnmĕihuàn
美貌	mĕimào
美夢	mĕimèng
美女	mĕinǚ
美人	mĕirén
*美容	mĕiróng
*美食	mĕishí
美食家	mĕishíjiā
美態	mĕitài
*美味	mĕiwèi
美艷	mĕiyàn
*美譽	mĕiyù
昧	mèi
魅	mèi
魅惑	mèihuò
媚	mèi
悶熱	mēnrè
門第	méndì
門戶	ménhù
門禁	ménjìn
*門檻	ménkǎn
門框	ménkuàng
門鈴	ménlíng
門路	mén·lu
門楣	ménméi
門牌	ménpái
*門票	ménpiào
門人	ménrén
門市	ménshì
門徒	méntú
*門診	ménzhĕn
悶氣	mènqì
蒙騙	mēngpiàn
萌	méng
萌生	méngshēng
盟	méng
盟軍	méngjūn
蒙蔽	méngbì
*蒙受	méngshòu
蒙羞	méngxiū
朦朧	ménglóng
猛力	mĕnglì
猛然	mĕngrán
*夢幻	mènghuàn
夢境	mèngjìng
夢寐以求	mèngmèiyǐqiú
夢鄉	mèngxiāng
*夢想	mèngxiǎng
夢魘	mèngyǎn
夢遊	mèngyóu
夢囈	mèngyì
迷宮	mígōng
迷糊	mí·hu
迷離	mílí
迷戀	míliàn
迷路	mílù
迷亂	míluàn
迷茫	mímáng
迷你	mínǐ
迷你裙	mínǐqún
迷惘	míwǎng
謎底	mídǐ
*謎語	míyŭ
彌	mí
彌撒	mí·sa
米醋	mǐcù
*米飯	mǐfàn
米糠	mǐkāng
米線	mǐxiàn
秘	mì
秘方	mìfāng
秘笈	mìjí
秘訣	mìjué
密不可分	mìbùkĕfēn
密佈	mìbù
*密封	mìfēng
*密碼	mìmǎ
蜜桃	mìtáo
蜜月	mìyuè
蜜棗	mìzǎo
覓	mì
覓食	mìshí
眠	mián
棉襖	mián'ǎo
棉被	miánbèi
棉絮	miánxù
綿	mián
綿延	miányán
免不了	miǎn·buliǎo
免得	miǎn·dé
*免費	miǎnfèi
*免稅	miǎnshuì
免疫力	miǎnyìlì
免職	miǎnzhí
勉	miǎn
緬懷	miǎnhuái
靦腆	miǎn·tiǎn
面額	miàn'é
面頰	miànjiá
面具	miànjù
面膜	miànmó
面色	miànsè
面紗	miànshā
面世	miànshì
面試	miànshì
面談	miàntán
面相	miànxiàng
面罩	miànzhào
*面值	miànzhí
*麵包	miànbāo
*麵粉	miànfĕn
苗條	miáo·tiao
描	miáo
瞄	miáo
渺	miǎo
渺茫	miǎománg
藐視	miǎoshì
妙齡	miàolíng
妙趣	miàoqù
妙趣橫生	miàoqùhéngshēng
妙語	miàoyŭ
*廟宇	miàoyŭ
滅火	mièhuŏ
滅絕	mièjué
民調	míndiào
*民航	mínháng
民居	mínjū
*民生	mínshēng
民望	mínwàng
民心	mínxīn
民謠	mínyáo
民營	mínyíng
民宅	mínzhái
民政	mínzhèng
皿	mǐn
泯滅	mǐnmiè
名不虛傳	míngbùxūchuán
*名冊	míngcè
名城	míngchéng
名存實亡	míngcúnshíwáng
*名單	míngdān
*名額	míng'é
名分	míngfèn
名副其實	míngfùqíshí
名號	mínghào
名家	míngjiā
名利	mínglì
名列前茅	mínglièqiánmáo
名流	míngliú
名牌	míngpái
名片	míngpiàn
名氣	míngqì
*名人	míngrén
名山	míngshān
名勝	míngshèng
名師	míngshī
名堂	míng·tang
名校	míngxiào
名媛	míngyuán
名正言順	míngzhèngyánshùn
名著	míngzhù
銘	míng
銘文	míngwén
*明快	míngkuài
*明朗	mínglǎng
明麗	mínglì
明瞭	míngliǎo
明媚	míngmèi
明滅	míngmiè
*明日	míngrì
明文	míngwén
*明星	míngxīng
明月	míngyuè
明證	míngzhèng
明知故犯	míngzhīgùfàn
明智	míngzhì
冥想	míngxiǎng
命案	mìng'àn
命脈	mìngmài
命中	mìngzhòng
命中率	mìngzhònglǜ
摹	mó
摹仿	mófǎng
膜拜	móbài
磨擦	mócā
磨練	móliàn
磨滅	mómiè
磨難	mónàn
磨損	mósŭn
摩托	mótuō
摩托車	mótuōchē
魔	mó
魔法	mófǎ
魔幻	móhuàn
魔力	mólì
魔術	móshù
魔術師	móshùshī
抹黑	mŏhēi
抹煞	mŏshā
末代	mòdài
末端	mòduān
末日	mòrì
沫	mò
陌路	mòlù
陌生人	mòshēngrén
*莫大	mòdà
莫非	mòfēi
莫名	mòmíng
莫名其妙	mòmíngqímiào
漠不關心	mòbùguānxīn
漠然	mòrán
漠視	mòshì
墨跡	mòjì
墨鏡	mòjìng
*墨魚	mòyú
默	mò
默哀	mò'āi
默不作聲	mòbùzuòshēng
默契	mòqì
默然	mòrán
默書	mòshū
默寫	mòxiĕ
默許	mòxŭ
驀地	mòdì
驀然	mòrán
*牟利	móulì
謀利	móulì
謀略	móulüè
謀取	móuqŭ
*謀殺	móushā
謀生	móushēng
模具	mújù
母女	mŭnǚ
母親節	Mŭ·qīnjié
母校	mŭxiào
*母語	mŭyŭ
姆指	mŭzhǐ
牡丹	mŭ·dān
木板	mùbǎn
木雕	mùdiāo
木耳	mù'ĕr
木筏	mùfá
木工	mùgōng
*木瓜	mùguā
木偶	mù'ŏu
沐浴	mùyù
目不暇接	mùbùxiájiē
目不轉睛	mùbùzhuǎnjīng
目瞪口呆	mùdèngkŏudāi
*目的地	mùdìdì
目擊	mùjī
*目錄	mùlù
目送	mùsòng
目眩	mùxuàn
牧	mù
牧師	mù·shi
牧童	mùtóng
募	mù
募集	mùjí
募捐	mùjuān
墓碑	mùbēi
墓地	mùdì
墓室	mùshì
墓穴	mùxué
墓葬	mùzàng
幕僚	mùliáo
幕門	mùmén
幕牆	mùqiáng
慕名	mùmíng
暮	mù
暮色	mùsè
穆	mù
拿號兒	náhàor
納粹	Nàcuì
納悶兒	nàmènr
*奶茶	nǎichá
奶油	nǎiyóu
奈何	nàihé
耐久	nàijiŭ
耐熱	nàirè
耐性	nàixìng
男孩兒	nánháir
男生	nánshēng
*男士	nánshì
男子漢	nánzǐhàn
南方人	nánfāngrén
南風	nánfēng
*南瓜	nán·guā
南柯一夢	Nánkēyīmèng
南轅北轍	nányuánbĕizhé
喃喃自語	nánnánzìyŭ
難點	nándiǎn
*難度	nándù
*難忘	nánwàng
難為	nán·wei
難為情	nánwéiqíng
難以置信	nányǐzhìxìn
囊括	nángkuò
惱	nǎo
惱怒	nǎonù
惱羞成怒	nǎoxiūchéngnù
腦幹	nǎogàn
腦海	nǎohǎi
腦筋	nǎojīn
腦膜	nǎomó
鬧哄哄	nàohōnghōng
鬧劇	nàojù
鬧市	nàoshì
鬧鐘	nàozhōng
內分泌	nèifēnmì
*內河	nèihé
內疚	nèijiù
內斂	nèiliǎn
*內陸	nèilù
內務	nèiwù
內線	nèixiàn
內向	nèixiàng
內銷	nèixiāo
內需	nèixū
內衣	nèiyī
能動	néngdòng
能幹	nénggàn
能歌善舞	nénggēshànwŭ
能見度	néngjiàndù
能耐	néng·nai
能說會道	néngshuōhuìdào
尼	ní
尼姑	nígū
尼古丁	nígŭdīng
泥地	nídì
泥濘	nínìng
呢喃	nínán
倪	ní
霓虹	níhóng
霓虹燈	níhóngdēng
你好	nǐhǎo
*擬訂	nǐdìng
*擬定	nǐdìng
擬稿	nǐgǎo
擬議	nǐyì
逆差	nìchā
逆境	nìjìng
*逆轉	nìzhuǎn
匿名	nìmíng
溺	nì
膩	nì
年表	niánbiǎo
年產量	niánchǎnliàng
年飯	niánfàn
*年份	niánfèn
*年糕	niángāo
*年華	niánhuá
年畫	niánhuà
年貨	niánhuò
年假	niánjià
年檢	niánjiǎn
年老	niánlǎo
年曆	niánlì
年輪	niánlún
年邁	niánmài
年輕化	niánqīnghuà
年時	niánshí
年頭兒	niántóur
年尾	niánwĕi
年息	niánxī
年薪	niánxīn
年夜	niányè
年夜飯	niányèfàn
年幼	niányòu
年終	niánzhōng
年資	niánzī
黏	nián
黏膜	niánmó
黏液	niányè
釀	niàng
釀酒	niàngjiŭ
釀造	niàngzào
釀製	niàngzhì
鳥瞰	niǎokàn
鳥語花香	niǎoyŭhuāxiāng
尿液	niàoyè
聶	niè
孽	niè
您好	nínhǎo
凝集	níngjí
凝聚力	níngjùlì
凝神	níngshén
凝望	níngwàng
凝重	níngzhòng
*檸檬	níngméng
檸檬茶	níngméngchá
牛奶	niúnǎi
牛排	niúpái
牛皮大王	niúpídàwáng
*牛肉	niúròu
牛市	niúshì
*牛油	niúyóu
牛仔褲	niúzǎikù
扭動	niŭdòng
扭曲	niŭqū
紐扣	niŭkòu
拗	niù
農地	nóngdì
農夫	nóngfū
*農曆	nónglì
*農莊	nóngzhuāng
*濃烈	nóngliè
濃密	nóngmì
濃縮	nóngsuō
*濃郁	nóngyù
濃重	nóngzhòng
弄虛作假	nòngxūzuòjiǎ
奴	nú
奴婢	núbì
*女孩兒	nǚháir
*女皇	nǚhuáng
女郎	nǚláng
女神	nǚshén
*女生	nǚshēng
女士	nǚshì
暖和	nuǎn·huo
暖流	nuǎnliú
暖意	nuǎnyì
虐待	nüèdài
瘧疾	nüèjí
挪	nuó
挪用	nuóyòng
諾貝爾獎	Nuòbèi'ĕrJiǎng
諾言	nuòyán
懦弱	nuòruò
*糯米	nuòmǐ
哦	ó
哦	ò
鷗	ōu
偶而	ŏu'ér
*偶像	ŏuxiàng
偶遇	ŏuyù
爬山	páshān
爬行	páxíng
帕	pà
拍案叫絕	pāi'ànjiàojué
拍板	pāibǎn
拍打	pāi·da
*拍賣	pāimài
拍手	pāishŏu
*拍照	pāizhào
*徘徊	páihuái
排場	pái·chǎng
排骨	páigŭ
排行	páiháng
排行榜	páihángbǎng
排洪	páihóng
排解	páijiĕ
*排練	páiliàn
排量	páiliàng
*排列	páiliè
*排名	páimíng
排氣	páiqì
排球	páiqiú
排山倒海	páishāndǎohǎi
排水	páishuǐ
排外	páiwài
排位	páiwèi
排泄	páixiè
排泄物	páixièwù
排演	páiyǎn
排印	páiyìn
牌匾	páibiǎn
牌坊	pái·fāng
*牌照	páizhào
*派對	pàiduì
*派發	pàifā
派系	pàixì
派駐	pàizhù
攀爬	pānpá
攀山	pānshān
攀升	pānshēng
攀談	pāntán
攀越	pānyuè
盤踞	pánjù
盤繞	pánrào
盤算	pán·suan
*盤問	pánwèn
判詞	pàncí
判斷力	pànduànlì
判罰	pànfá
判決書	pànjuéshū
*判刑	pànxíng
判罪	pànzuì
叛	pàn
叛亂	pànluàn
叛逆	pànnì
畔	pàn
膀	pāng
旁邊	pángbiān
旁人	pángrén
旁聽	pángtīng
旁證	pángzhèng
徬徨	pánghuáng
螃蟹	pángxiè
龐	páng
龐然大物	pángrándàwù
拋錨	pāomáo
拋售	pāoshòu
咆哮	páoxiào
*炮製	páozhì
袍	páo
跑步	pǎobù
跑車	pǎochē
*跑馬	pǎomǎ
泡菜	pàocài
泡飯	pàofàn
*泡沫	pàomò
炮兵	pàobīng
炮轟	pàohōng
*炮台	pàotái
炮仗	pào·zhang
培	péi
培植	péizhí
陪伴	péibàn
陪襯	péichèn
*陪審團	péishĕntuán
*陪審員	péishĕnyuán
*陪同	péitóng
陪葬	péizàng
賠	péi
佩	pèi
佩戴	pèidài
*配備	pèibèi
配搭	pèidā
*配對	pèiduì
*配額	pèi'é
配給	pèijǐ
配件	pèijiàn
*配角	pèijué
*配料	pèiliào
*配偶	pèi'ŏu
配飾	pèishì
配售	pèishòu
配藥	pèiyào
配音	pèiyīn
配樂	pèiyuè
配製	pèizhì
噴泉	pēnquán
噴水池	pēnshuǐchí
噴嚏	pēn·tì
噴霧	pēnwù
盆栽	pénzāi
盆子	pén·zi
抨擊	pēngjī
怦然心動	pēngránxīndòng
烹	pēng
*烹飪	pēngrèn
*烹調	pēngtiáo
烹製	pēngzhì
烹煮	pēngzhŭ
蓬	péng
篷	péng
澎湃	péngpài
捧場	pĕngchǎng
捧腹	pĕngfù
碰面	pèngmiàn
碰巧	pèngqiǎo
碰頭	pèngtóu
碰運氣	pèngyùnqi
碰撞	pèngzhuàng
披甲	pījiǎ
*披露	pīlù
批發價	pīfājià
批註	pīzhù
皮層	pícéng
皮蛋	pídàn
*皮膚癌	pífū'ái
皮球	píqiú
皮箱	píxiāng
皮鞋	píxié
疲	pí
疲憊	píbèi
疲累	pílèi
疲弱	píruò
枇杷	pí·pá
毗連	pílián
*毗鄰	pílín
琵琶	pí·pá
脾臟	pízàng
匹配	pǐpèi
癖	pǐ
癖好	pǐhào
屁	pì
媲美	pìmĕi
譬喻	pìyù
闢	pì
偏愛	piān'ài
偏方	piānfāng
偏好	piānhào
偏激	piānjī
偏離	piānlí
偏頗	piānpō
偏食	piānshí
偏遠	piānyuǎn
偏執	piānzhí
偏重	piānzhòng
*篇幅	piān·fú
篇章	piānzhāng
翩翩起舞	piānpiānqǐwŭ
片場	piànchǎng
片酬	piànchóu
*片段	piànduàn
片斷	piànduàn
騙取	piànqŭ
騙子	piàn·zi
漂	piāo
漂泊	piāobó
*漂浮	piāofú
漂流	piāoliú
漂移	piāoyí
飄蕩	piāodàng
飄動	piāodòng
飄浮	piāofú
飄忽	piāohū
飄落	piāoluò
飄散	piāosàn
瓢	piáo
漂	piǎo
漂白	piǎobái
*票房	piàofáng
*票價	piàojià
*票據	piàojù
瞥	piē
瞥見	piējiàn
拼	pīn
拼搏	pīnbó
拼湊	pīncòu
拼合	pīnhé
拼盤	pīnpán
拼圖	pīntú
拼寫	pīnxiĕ
拼音	pīnyīn
貧血	pínxuè
頻	pín
頻道	píndào
*品嘗	pǐncháng
品類	pǐnlèi
品格	pǐngé
*品牌	pǐnpái
品評	pǐnpíng
品性	pǐnxìng
*品味	pǐnwèi
聘	pìn
聘書	pìnshū
*聘請	pìnqǐng
*聘用	pìnyòng
平常心	píngchángxīn
平淡	píngdàn
平底鍋	píngdǐguō
平地	píngdì
平反	píngfǎn
平方	píngfāng
平房	píngfáng
平復	píngfù
平和	pínghé
平滑	pínghuá
平緩	pínghuǎn
平價	píngjià
平民化	píngmínhuà
平實	píngshí
平手	píngshŏu
*平台	píngtái
平息	píngxī
平心靜氣	píngxīnjìngqì
平易近人	píngyìjìnrén
平庸	píngyōng
平仄	píngzè
坪	píng
屏風	píngfēng
*評分	píngfēn
*評級	píngjí
評鑒	pingjiàn
評判	píngpàn
*評審	píngshĕn
評述	píngshù
評說	píngshuō
評委	píngwĕi
評議	píngyì
評語	píngyŭ
憑弔	píngdiào
憑空	pingkōng
泊	pō
潑	pō
潑辣	pō·là
迫不得已	pòbùdéyǐ
迫不及待	pòbùjídài
破案	pò'àn
破格	pògé
破解	pòjiĕ
破例	pòlì
破門	pòmén
破滅	pòmiè
破損	pòsŭn
破天荒	pòtiānhuāng
破曉	pòxiǎo
破綻	pò·zhàn
魄	pò
魄力	pòlì
剖	pōu
剖析	pōuxī
撲鼻	pūbí
撲救	pūjiù
撲克	pūkè
撲空	pūkōng
撲朔迷離	pūshuòmílí
鋪陳	pūchén
鋪蓋	pūgài
鋪排	pū·pái
鋪天蓋地	pūtiāngàidì
*葡萄酒	pú·táojiŭ
僕	pú
圃	pŭ
普	pŭ
*普查	pŭchá
普度	pŭdù
*普羅	pŭluó
普通法	pŭtōngfǎ
普選	pŭxuǎn
普照	pŭzhào
譜寫	pŭxiĕ
樸實	pŭshí
樸拙	pŭzhuō
堡	pù
*瀑布	pùbù
曝曬	pùshài
沏	qī
沏茶	qīchá
戚	qī
悽楚	qīchŭ
棲息	qīxī
淒厲	qīlì
淒美	qīmĕi
淒迷	qīmí
漆器	qīqì
欺	qī
欺壓	qīyā
*欺詐	qīzhà
期盼	qīpàn
期許	qīxŭ
其貌不揚	qímàobùyáng
旗杆	qígān
旗鼓相當	qígŭxiāngdāng
旗艦	qíjiàn
旗開得勝	qíkāidéshèng
旗袍	qípáo
棋	qí
麒麟	qílín
*歧視	qíshì
奇詭	qíguǐ
奇幻	qíhuàn
奇景	qíjǐng
*奇妙	qímiào
奇謀	qímóu
奇趣	qíqù
奇遇	qíyù
崎嶇	qíqū
騎馬	qímǎ
祈	qí
祈禱	qídǎo
祈福	qífú
*祈求	qíqiú
齊備	qíbèi
齊心協力	qíxīnxiélì
臍帶	qídài
企鵝	qǐ'é
乞丐	qǐgài
豈止	qǐzhǐ
啟	qǐ
啟迪	qǐdí
*啟動	qǐdòng
啟航	qǐháng
啟蒙	qǐméng
*啟用	qǐyòng
*起步	qǐbù
起程	qǐchéng
起床	qǐchuáng
起火	qǐhuŏ
起勁	qǐjìn
起居	qǐjū
起落	qǐluò
起訴	qǐsù
起訴書	qǐsùshū
起因	qǐyīn
起眼	qǐyǎn
綺麗	qǐlì
迄	qì
迄今	qìjīn
汽	qì
汽水	qìshuǐ
氣喘	qìchuǎn
氣促	qìcù
氣袋	qìdài
氣墊	qìdiàn
氣度	qìdù
氣管	qìguǎn
氣節	qìjié
氣概	qìgài
氣餒	qìnĕi
氣派	qìpài
氣泡	qìpào
氣球	qìqiú
氣旋	qìxuán
氣韻	qìyùn
泣	qì
契	qì
契機	qìjī
棄權	qìquán
*棄置	qìzhì
器量	qìliàng
*器皿	qìmǐn
恰	qià
恰巧	qiàqiǎo
洽	qià
洽商	qiàshāng
千瘡百孔	qiānchuāngbǎikŏng
千錘百煉	qiānchuíbǎiliàn
千古	qiāngŭ
千金	qiānjīn
千篇一律	qiānpiānyīlǜ
千奇百怪	qiānqíbǎiguài
千絲萬縷	qiānsīwànlǚ
千萬	qiānwàn
牽動	qiāndòng
牽掛	qiānguà
牽連	qiānlián
牽強	qiānqiǎng
*牽涉	qiānshè
牽頭	qiāntóu
慳	qiān
遷就	qiānjiù
遷居	qiānjū
遷離	qiānlí
遷徙	qiānxǐ
謙卑	qiānbēi
簽	qiān
*簽發	qiānfā
*簽名	qiānmíng
*簽署	qiānshŭ
簽約	qiānyuē
*簽證	qiānzhèng
前端	qiánduān
*前鋒	qiánfēng
前夫	qiánfū
前妻	qiánqī
前任	qiánrèn
*前日	qiánrì
前生	qiánshēng
前世	qiánshì
前所未有	qiánsuŏwèiyŏu
前天	qiántiān
前衛	qiánwèi
前夕	qiánxī
前行	qiánxíng
前言	qiányán
前因後果	qiányīnhòuguŏ
前瞻	qiánzhān
*前者	qiánzhĕ
前奏	qiánzòu
虔誠	qiánchéng
乾	qián
乾坤	qiánkūn
錢包	qiánbāo
錢幣	qiánbì
錢財	qiáncái
潛伏	qiánfú
*潛能	qiánnéng
潛入	qiánrù
潛逃	qiántáo
潛艇	qiántǐng
潛心	qiánxīn
潛移默化	qiányímòhuà
潛意識	qiányìshí
*潛質	qiánzhì
淺白	qiǎnbái
淺薄	qiǎnbó
淺色	qiǎnsè
淺顯	qiǎnxiǎn
遣返	qiǎnfǎn
遣散	qiǎnsàn
*遣散費	qiǎnsànfèi
遣送	qiǎnsòng
*譴責	qiǎnzé
*欠缺	qiànquē
歉	qiàn
歉疚	qiànjiù
槍擊	qiāngjī
槍林彈雨	qiānglíndànyŭ
槍械	qiāngxiè
強健	qiángjiàn
*強勁	qiángjìng
強弱	qiángruò
強身	qiángshēn
強勢	qiángshì
強效	qiángxiào
強心針	qiángxīnzhēn
強硬	qiángyìng
強壯	qiángzhuàng
牆角	qiángjiǎo
牆紙	qiángzhǐ
搶購	qiǎnggòu
搶手	qiǎngshŏu
搶先	qiǎngxiān
搶眼	qiǎngyǎn
搶佔	qiǎngzhàn
悄悄話	qiāoqiāohuà
*敲擊	qiāojī
蹺	qiāo
蹺蹊	qiāo·qi
橋面	qiáomiàn
憔悴	qiáocuì
翹	qiáo
翹楚	qiáochŭ
巧奪天工	qiǎoduótiāngōng
巧合	qiǎohé
巧克力	qiǎokèlì
巧手	qiǎoshŏu
巧遇	qiǎoyù
悄然	qiǎorán
俏	qiào
俏麗	qiàolì
竅	qiào
竅門	qiàomén
翹	qiào
切除	qiēchú
切磋	qiēcuō
切割	qiēgē
切口	qiēkŏu
切片	qiēpiàn
切線	qiēxiàn
茄	qié
*茄子	qié·zi
*切合	qièhé
切忌	qièjì
切身	qièshēn
怯	qiè
怯懦	qiènuò
愜意	qièyì
鍥而不捨	qiè'érbùshĕ
竊	qiè
竊竊私語	qièqièsīyŭ
侵奪	qīnduó
侵擾	qīnrǎo
侵吞	qīntūn
親近	qīnjìn
*親臨	qīnlín
親昵	qīnnì
親情	qīnqíng
親善	qīnshàn
*親身	qīnshēn
親王	qīnwáng
親吻	qīnwĕn
親信	qīnxìn
*親子	qīnzǐ
芹	qín
芹菜	qíncài
禽	qín
*禽鳥	qínniǎo
*禽畜	qínchù
勤快	qín·kuai
勤勉	qínmiǎn
寢	qǐn
寢室	qǐnshì
沁	qìn
沁人心脾	qìnrénxīnpí
青春期	qīngchūnqī
青蔥	qīngcōng
青翠	qīngcuì
青睞	qīnglài
青梅竹馬	qīngméizhúmǎ
*青銅	qīngtóng
青雲	qīngyún
清白	qīngbái
清澈	qīngchè
清純	qīngchún
清脆	qīngcuì
*清單	qīngdān
*清淡	qīngdàn
清風	qīngfēng
清還	qīnghuán
清潔劑	qīngjiéjì
清靜	qīngjìng
清涼	qīngliáng
清亮	qīngliàng
清明	qīngmíng
清明節	Qīngmíngjié
*清盤	qīngpán
清貧	qīngpín
清爽	qīngshuǎng
*清算	qīngsuàn
清洗	qīngxǐ
*清香	qīngxiāng
*清新	qīngxīn
清雅	qīngyǎ
清幽	qīngyōu
清早	qīngzǎo
清真寺	qīngzhēnsì
清賬	qīngzhàng
清蒸	qīngzhēng
蜻蜓	qīngtíng
卿	qīng
傾倒	qīngdǎo
傾倒	qīngdào
傾力	qīnglì
傾慕	qīngmù
傾盆	qīngpén
傾情	qīngqíng
傾訴	qīngsù
傾談	qīngtán
*傾銷	qīngxiāo
*傾瀉	qīngxiè
傾軋	qīngyà
輕薄	qīngbó
輕而易舉	qīng'éryìjŭ
輕巧	qīng·qiǎo
輕柔	qīngróu
輕生	qīngshēng
輕佻	qīngtiāo
輕盈	qīngyíng
情不自禁	qíngbùzìjīn
情敵	qíngdí
情調	qíngdiào
*情歌	qínggē
*情懷	qínghuái
情結	qíngjié
*情侶	qínglǚ
*情人	qíngrén
情人節	Qíngrénjié
情勢	qíngshì
情書	qíngshū
情態	qíngtài
情投意合	qíngtóuyìhé
情意	qíngyì
情義	qíngyì
情誼	qíngyì
情慾	qíngyù
情緣	qíngyuán
情願	qíngyuàn
情韻	qíngyùn
晴	qíng
晴空	qíngkōng
擎	qíng
擎天	qíngtiān
請假	qǐngjià
請柬	qǐngjiǎn
*請教	qǐngjiào
請客	qǐngkè
請求	qǐngqiú
請願	qǐngyuàn
慶	qìng
*慶典	qìngdiǎn
慶幸	qìngxìng
穹蒼	qióngcāng
窮困	qióngkùn
丘陵	qiūlíng
蚯蚓	qiūyǐn
秋高氣爽	qiūgāoqìshuǎng
仇	Qiú
囚	qiú
*囚犯	qiúfàn
囚禁	qiújìn
求愛	qiú'ài
求教	qiújiào
求情	qiúqíng
求生	qiúshēng
*求診	qiúzhĕn
求知	qiúzhī
*求職	qiúzhí
*求助	qiúzhù
球場	qiúchǎng
球技	qiújì
*球迷	qiúmí
球拍	qiúpāi
*球賽	qiúsài
球手	qiúshŏu
球壇	qiútán
球鞋	qiúxié
球衣	qiúyī
球員	qiúyuán
曲尺	qūchǐ
屈	qū
屈就	qūjiù
區旗	qūqí
軀	qū
軀幹	qūgàn
軀體	qūtǐ
驅車	qūchē
驅除	qūchú
驅動	qūdòng
驅趕	qūgǎn
驅使	qūshǐ
趨之若鶩	qūzhīruòwù
曲調	qŭdiào
曲高和寡	qŭgāohèguǎ
*曲目	qŭmù
曲藝	qŭyì
曲終人散	qŭzhōngrénsàn
曲子	qŭ·zi
取材	qŭcái
取長補短	qŭchángbŭduǎn
取締	qŭdì
取而代之	qŭ'érdàizhī
取經	qŭjīng
取景	qŭjǐng
取名	qŭmíng
取巧	qŭqiǎo
取捨	qŭshĕ
取勝	qŭshèng
*取向	qŭxiàng
取笑	qŭxiào
取悅	qŭyuè
去路	qùlù
去聲	qùshēng
去向	qùxiàng
趣	qù
趣事	qùshì
*全程	quánchéng
*全都	quándōu
*全方位	quánfāngwèi
*全力	quánlì
全力以赴	quánlìyǐfù
全貌	quánmào
全面	quánmiàn
全盤	quánpán
*全球化	quánqiúhuà
全然	quánrán
*全日制	quánrìzhì
全神貫注	quánshénguànzhù
全盛	quánshèng
*全數	quánshù
全天候	quántiānhòu
全文	quánwén
全心全意	quánxīnquányì
*全新	quánxīn
*全職	quánzhí
全自動	quánzìdòng
痊愈	quányù
詮釋	quánshì
泉水	quánshuǐ
泉源	quányuán
拳擊	quánjī
拳腳	quánjiǎo
權貴	quánguì
權衡	quánhéng
權謀	quánmóu
權術	quánshù
權宜	quányí
權責	quánzé
*犬	quǎn
券	quàn
勸勉	quànmiǎn
勸諭	quànyù
缺憾	quēhàn
*缺席	quēxí
缺陣	quēzhèn
卻步	quèbù
雀	què
雀斑	quèbān
雀躍	quèyuè
裙	qún
裙擺	qúnbǎi
裙帶	qúndài
裙子	qún·zi
群策群力	qúncèqúnlì
燃點	rándiǎn
燃眉之急	ránméizhījí
*染病	rǎnbìng
染指	rǎnzhǐ
讓座	ràngzuò
饒	ráo
擾	rǎo
擾攘	rǎorǎng
繞道	ràodào
繞口令	ràokŏulìng
惹火	rĕhuŏ
熱忱	rèchén
*熱誠	rèchéng
熱帶雨林	rèdàiyŭlín
*熱點	rèdiǎn
熱度	rèdù
熱辣辣	rèlālā
熱力	rèlì
*熱門	rèmén
熱氣	rèqì
熱切	rèqiè
熱身	rèshēn
熱騰騰	rètēngtēng
*熱線	rèxiàn
熱血	rèxuè
熱飲	rèyǐn
人本	rénbĕn
人潮	réncháo
*人稱	rénchēng
人次	réncì
*人和	rénhé
人跡	rénjì
人際	rénjì
人傑地靈	rénjiédìlíng
*人流	rénliú
人名	rénmíng
人氣	rénqì
人情	rénqíng
人情味	rénqíngwèi
*人權	rénquán
人山人海	rénshānrénhǎi
人世	rénshì
人文	rénwén
人行道	rénxíngdào
*人選	rénxuǎn
人煙	rényān
人緣	rényuán
人中	rénzhōng
人種	rénzhŏng
仁愛	rén'ài
忍氣吞聲	rĕnqìtūnshēng
忍辱	rĕnrŭ
忍無可忍	rĕnwúkĕrĕn
忍心	rĕnxīn
刃	rèn
韌	rèn
韌帶	rèndài
*任教	rènjiào
任勞任怨	rènláorènyuàn
任免	rènmiǎn
*任期	rènqī
任用	rènyòng
*任職	rènzhí
任重道遠	rènzhòngdàoyuǎn
認錯	rèncuò
*認購	rèngòu
認領	rènlǐng
認輸	rènshū
*認同	rèntóng
*認證	rènzhèng
*認知	rènzhī
日常	rìcháng
日光	rìguāng
日光燈	rìguāngdēng
日光浴	rìguāngyù
*日後	rìhòu
日積月累	rìjīyuèlĕi
*日間	rìjiān
*日漸	rìjiàn
日上三竿	rìshàngsāngān
日新月異	rìxīnyuèyì
日以繼夜	rìyǐjìyè
日照	rìzhào
容貌	róngmào
*容許	róngxŭ
溶洞	róngdòng
榮	róng
*榮獲	rónghuò
*榮幸	róngxìng
榮耀	róngyào
榮膺	róngyīng
融	róng
融和	rónghé
融會貫通	rónghuìguàntōng
*融入	róngrù
*融資	róngzī
冗長	rŏngcháng
柔	róu
柔美	róumĕi
柔情	róuqíng
柔韌	róurèn
柔弱	róuruò
柔順	róushùn
糅合	róuhé
蹂躪	róulìn
肉麻	ròumá
肉眼	ròuyǎn
*肉質	ròuzhì
*如常	rúcháng
如癡如醉	rúchīrúzuì
如火如荼	rúhuŏrútú
如期	rúqī
如實	rúshí
如釋重負	rúshìzhòngfù
如意	rúyì
如願	rúyuàn
儒	rú
儒學	rúxué
儒雅	rúyǎ
乳房	rŭfáng
乳酪	rŭlào
乳酸菌	rŭsuānjūn
乳糖	rŭtáng
乳豬	rŭzhū
辱	rŭ
入場券	rùchǎngquàn
*入股	rùgŭ
入夥	rùhuŏ
*入境	rùjìng
*入口	rùkŏu
*入門	rùmén
入睡	rùshuì
入圍	rùwéi
入伍	rùwŭ
入鄉隨俗	rùxiāngsuísú
入選	rùxuǎn
入夜	rùyè
*入賬	rùzhàng
入座	rùzuò
軟骨	ruǎngŭ
軟和	ruǎn·huo
蕊	ruǐ
銳	ruì
銳不可當	ruìbùkĕdāng
銳意	ruìyì
睿智	ruìzhì
閏	rùn
閏月	rùnyuè
潤	rùn
潤澤	rùnzé
若無其事	ruòwúqíshì
偌大	ruòdà
弱視	ruòshì
*弱勢	ruòshì
弱智	ruòzhì
撒嬌	sājiāo
灑落	sǎluò
塞外	Sàiwài
塞翁失馬	sàiwēngshīmǎ
賽車	sàichē
*賽馬	sàimǎ
賽跑	sàipǎo
*賽事	sàishì
賽制	sàizhì
三思	sānsī
散漫	sǎnmàn
散裝	sǎnzhuāng
散播	sànbō
散場	sànchǎng
散亂	sànluàn
散落	sànluò
散失	sànshī
桑	sāng
桑拿	sāngná
喪禮	sānglǐ
嗓	sǎng
嗓門兒	sǎngménr
嗓音	sǎngyīn
喪生	sàngshēng
搔	sāo
騷	sāo
騷動	sāodòng
騷亂	sāoluàn
騷擾	sāorǎo
嫂	sǎo
掃除	sǎochú
掃描	sǎomiáo
掃墓	sǎomù
掃地	sǎodì
掃興	sǎoxìng
掃帚	sào·zhou
色調	sèdiào
色盲	sèmáng
色情	sèqíng
色素	sèsù
色相	sèxiàng
*色澤	sèzé
瑟	sè
瑟縮	sèsuō
澀	sè
僧多粥少	sēngduōzhōushǎo
沙場	shāchǎng
沙鍋	shāguō
沙龍	shālóng
沙嗓子	shāsǎng·zi
沙啞	shāyǎ
砂糖	shātáng
鯊魚	shāyú
剎	shā
剎車	shāchē
殺蟲劑	shāchóngjì
殺價	shājià
殺戮	shālù
殺傷	shāshāng
殺傷力	shāshānglì
煞	shā
煞車	shāchē
霎時	shàshí
煞	shà
篩	shāi
篩選	shāixuǎn
山城	shānchéng
山川	shānchuān
山村	shāncūn
山洞	shāndòng
山火	shānhuŏ
山巒	shānluán
*山坡	shānpō
山清水秀	shānqīngshuǐxiù
山丘	shānqiū
山水畫	shānshuǐhuà
山野	shānyĕ
山楂	shānzhā
舢舨	shānbǎn
刪除	shānchú
刪減	shānjiǎn
*珊瑚	shānhú
珊瑚礁	shānhújiāo
煽動	shāndòng
煽情	shānqíng
閃避	shǎnbì
閃動	shǎndòng
閃亮	shǎnliàng
訕笑	shànxiào
善本	shànbĕn
善惡	shàn'è
善後	shànhòu
善舉	shànjŭ
善款	shànkuǎn
善心	shànxīn
*善信	shànxìn
膳	shàn
*膳食	shànshí
*擅長	shàncháng
擅用	shànyòng
禪	shàn
贍養	shànyǎng
商場	shāngchǎng
商船	shāngchuán
商販	shāngfàn
*商號	shānghào
*商戶	shānghù
*商會	shānghuì
*商機	shāngjī
商家	shāngjiā
商界	shāngjiè
商旅	shānglǚ
*商貿	shāngmào
*商廈	shāngshà
商談	shāngtán
*商務	shāngwù
商譽	shāngyù
傷悲	shāngbēi
*傷殘	shāngcán
傷風	shāngfēng
傷感	shānggǎn
傷痕	shānghén
傷腦筋	shāngnǎojīn
傷勢	shāngshì
傷痛	shāngtòng
*傷亡	shāngwáng
傷癒	shāngyù
上聲	shǎngshēng
賞光	shǎngguāng
賞臉	shǎngliǎn
賞識	shǎngshí
賞析	shǎngxī
賞心悅目	shǎngxīnyuèmù
上岸	shàng'àn
上場	shàngchǎng
上乘	shàngchéng
上等	shàngdĕng
上調	shàngdiào
上火	shànghuŏ
上進	shàngjìn
上流	shàngliú
上馬	shàngmǎ
上門	shàngmén
上身	shàngshēn
上司	shàng·si
上天	shàngtiān
上調	shàngtiáo
*上限	shàngxiàn
*上演	shàngyǎn
上揚	shàngyáng
上癮	shàngyǐn
上映	shàngyìng
*上陣	shàngzhèn
上肢	shàngzhī
燒毀	shāohuǐ
*燒烤	shāokǎo
燒賣	shāo·mai
燒傷	shāoshāng
勺	sháo
芍藥	sháoyao
*少不了	shǎo·buliǎo
*少許	shǎoxŭ
少艾	shào'ài
少將	shàojiàng
少林寺	Shàolínsì
哨	shào
哨子	shào·zi
奢侈	shēchǐ
奢華	shēhuá
奢靡	shēmí
奢望	shēwàng
賒帳	shēzhàng
捨棄	shĕqì
*社交	shèjiāo
*社區	shèqū
*社群	shèqún
社團	shètuán
射程	shèchéng
射箭	shèjiàn
射門	shèmén
射頻	shèpín
*射手	shèshŏu
涉	shè
涉案	shè'àn
涉及	shèjí
*涉嫌	shèxián
涉足	shèzú
*設定	shèdìng
設防	shèfáng
*設計師	shèjìshī
攝錄	shèlù
*攝取	shèqŭ
*攝氏	shèshì
*攝影機	shèyǐngjī
攝製	shèzhì
申	shēn
申辦	shēnbàn
*申報	shēnbào
申辯	shēnbiàn
*申領	shēnlǐng
*申訴	shēnsù
*申索	shēnsuŏ
*伸延	shēnyán
*伸展	shēnzhǎn
身段	shēnduàn
*身分證	shēn·fenzhèng
身高	shēngāo
身家	shēnjiā
身價	shēnjià
身世	shēnshì
身手	shēnshŏu
身體力行	shēntǐlìxíng
身形	shēnxíng
身孕	shēnyùn
深愛	shēn'ài
深層	shēncéng
深秋	shēnqiū
深入淺出	shēnrùqiǎnchū
深思	shēnsī
深思熟慮	shēnsīshúlǜ
深邃	shēnsuì
深宵	shēnxiāo
*深信	shènxìn
深淵	shēnyuān
*深造	shēnzào
神經質	shénjīngzhì
神龕	shénkān
神來之筆	shénláizhībǐ
神靈	shénlíng
神廟	shénmiào
神明	shénmíng
神似	shénsì
神童	shéntóng
神位	shénwèi
神像	shénxiàng
神韻	shényùn
神智	shénzhì
神州	Shénzhōu
嬸嬸	shĕn·shen
審	shĕn
*審核	shĕnhé
*審計	shĕnjì
審結	shĕnjié
*審批	shĕnpī
*審慎	shĕnshèn
審時度勢	shĕnshíduóshì
審視	shĕnshì
*審訊	shĕnxùn
*審議	shĕnyì
*審閱	shĕnyuè
腎臟	shènzàng
慎	shèn
滲	shèn
滲入	shènrù
*升幅	shēngfú
升格	shēnggé
升華	shēnghuá
*升級	shēngjí
升降	shēngjiàng
*升降機	shēngjiàngjī
升空	shēngkōng
升旗	shēngqí
*升勢	shēngshì
升溫	shēngwēn
*升值	shēngzhí
升職	shēngzhí
生不逢時	shēngbùféngshí
生根	shēnggēn
生還	shēnghuán
生活費	shēnghuófèi
生計	shēngjì
生離死別	shēnglísǐbié
生力軍	shēnglìjūn
生怕	shēngpà
生平	shēngpíng
生氣勃勃	shēngqìbóbó
生日	shēng·rì
*生死	shēngsǐ
生物學	shēngwùxué
生息	shēngxī
*生效	shēngxiào
*生涯	shēngyá
生字	shēngzì
*聲稱	shēngchēng
聲帶	shēngdài
聲控	shēngkòng
聲浪	shēnglàng
聲淚俱下	shēnglèijùxià
聲名	shēngmíng
聲望	shēngwàng
聲言	shēngyán
*聲譽	shēngyù
聲樂	shēngyuè
繩索	shéngsuŏ
繩網	shéngwǎng
省城	shĕngchéng
*省份	shĕngfèn
省卻	shĕngquè
*省時	shĕngshí
*盛產	shèngchǎn
盛傳	shèngchuán
盛會	shènghuì
盛況	shèngkuàng
*盛名	shèngmíng
盛世	shèngshì
*盛事	shèngshì
盛譽	shèngyù
盛讚	shèngzàn
盛裝	shèngzhuāng
剩貨	shènghuò
*剩下	shèng·xia
*勝地	shèngdì
勝負	shèngfù
勝任	shèngrèn
*勝訴	shèngsù
*聖誕	Shèngdàn
聖誕卡	shèngdànkǎ
聖誕老人	Shèngdànlǎorén
聖地	shèngdì
聖潔	shèngjié
聖母	shèngmŭ
聖人	shèngrén
聖詩	shèngshī
失常	shīcháng
失傳	shīchuán
失聰	shīcōng
*失當	shīdàng
失地	shīdì
失分	shīfēn
失衡	shīhéng
失魂落魄	shīhúnluòpò
失控	shīkòng
失禮	shīlǐ
失利	shīlì
失戀	shīliàn
失落	shīluò
*失眠	shīmián
失明	shīmíng
失竊	shīqiè
失散	shīsàn
失色	shīsè
失實	shīshí
失勢	shīshì
失手	shīshŏu
失守	shīshŏu
失修	shīxiū
失意	shīyì
失約	shīyuē
失職	shīzhí
失主	shīzhŭ
*失蹤	shīzōng
屍	shī
屍身	shīshēn
施教	shījiào
施展	shīzhǎn
*施政	shīzhèng
師弟	shīdì
師父	shī·fu
師姐	shījiĕ
師妹	shīmèi
師徒	shītú
師兄	shīxiōng
師訓	shīxùn
師資	shīzī
獅	shī
獅子	shī·zi
詩詞	shīcí
*詩集	shījí
詩篇	shīpiān
詩情畫意	shīqínghuàyì
詩壇	shītán
詩體	shītǐ
詩文	shīwén
*濕地	shīdì
濕熱	shīrè
十全十美	shíquánshímĕi
十字架	shízìjià
*十足	shízú
什	shí
什錦	shíjǐn
石板	shíbǎn
石碑	shíbēi
石壁	shíbì
石雕	shídiāo
石階	shíjiē
*石刻	shíkè
*石窟	shíkū
石榴	shí·liu
石棉	shímián
石像	shíxiàng
*石油氣	shíyóuqì
拾荒	shíhuāng
食道	shídào
食家	shíjiā
*食客	shíkè
食糧	shíliáng
食療	shíliáo
*食譜	shípŭ
食油	shíyóu
*食慾	shíyù
食指	shízhǐ
*時報	shíbào
時差	shíchā
時辰	shí·chen
*時段	shíduàn
時分	shífèn
*時光	shíguāng
時局	shíjú
時令	shílìng
時區	shíqū
*時尚	shíshàng
時勢	shíshì
時速	shísù
時序	shíxù
時限	shíxiàn
時宜	shíyí
時鐘	shízhōng
*時裝	shízhuāng
蝕	shí
*實地	shídì
實感	shígǎn
實情	shíqíng
*實務	shíwù
*實習	shíxí
實證	shízhèng
實至名歸	shízhìmíngguī
識趣	shíqù
史籍	shǐjí
*史前	shǐqián
史實	shǐshí
史無前例	shǐwúqiánlì
使館	shǐguǎn
駛	shǐ
矢	shǐ
矢志	shǐzhì
始創	shǐchuàng
始祖	shǐzŭ
士氣	shìqì
世間	shìjiān
世情	shìqíng
*世人	shìrén
*世上	shìshàng
世事	shìshì
世俗	shìsú
世態	shìtài
世外桃源	shìwàitáoyuán
世襲	shìxí
示弱	shìruò
示意	shìyì
巿場	shìchǎng
*市道	shìdào
*市區	shìqū
市集	shìjí
市價	shìjià
市郊	shìjiāo
市井	shìjǐng
*市面	shìmiàn
市容	shìróng
*市鎮	shìzhèn
市政	shìzhèng
柿子	shì·zi
式微	shìwēi
拭	shì
拭目以待	shìmùyǐdài
*試點	shìdiǎn
試金石	shìjīnshí
*試行	shìxíng
試探	shìtàn
試題	shìtí
試用	shìyòng
試用期	shìyòngqī
事半功倍	shìbàngōngbèi
*事前	shìqián
*事項	shìxiàng
*事宜	shìyí
*事主	shìzhŭ
侍	shì
侍奉	shìfèng
侍者	shìzhĕ
侍應	shìyìng
室溫	shìwēn
逝	shì
*視察	shìchá
視角	shìjiǎo
視力	shìlì
視頻	shìpín
*視聽	shìtīng
視網膜	shìwǎngmó
*視像	shìxiàng
視學	shìxué
勢頭	shì·tóu
嗜	shì
嗜好	shìhào
飾	shì
飾品	shìpǐn
飾物	shìwù
*飾演	shìyǎn
誓	shì
*誓詞	shìcí
適從	shìcóng
適得其反	shìdéqífǎn
適度	shìdù
適逢其會	shìféngqíhuì
適可而止	shìkĕ'érzhǐ
*適量	shìliàng
*適時	shìshí
適應	shìyìng
*適中	shìzhōng
噬	shì
釋然	shìrán
*收報	shōubào
*收藏	shōucáng
收場	shōuchǎng
收發	shōufā
*收費	shōufèi
收付	shōufù
*收據	shōujù
收看	shōukàn
收斂	shōuliǎn
*收錄	shōulù
收納	shōunà
*收取	shōuqŭ
收容	shōuróng
*收生	shōushēng
*收市	shōushì
收聽	shōutīng
收效	shōuxiào
收押	shōuyā
收養	shōuyǎng
收音	shōuyīn
收賬	shōuzhàng
*收支	shōuzhī
手背	shŏubèi
手筆	shŏubǐ
*手冊	shŏucè
手感	shŏugǎn
手稿	shŏugǎo
手工藝	shŏugōngyì
*手機	shŏujī
手帕	shŏupà
手套	shŏutào
手提包	shŏutíbāo
手頭	shŏutóu
手推車	shŏutuīchē
手腕	shŏuwàn
手舞足蹈	shŏuwŭzúdǎo
手下	shŏuxià
手藝	shŏuyì
手印	shŏuyìn
手語	shŏuyŭ
手足	shŏuzú
手足無措	shŏuzúwúcuò
手杖	shŏuzhàng
守法	shŏufǎ
守候	shŏuhòu
守護	shŏuhù
守門員	shŏuményuán
守望	shŏuwàng
守信	shŏuxìn
*守則	shŏuzé
*首創	shŏuchuàng
首次	shŏucì
首當其衝	shŏudāngqíchōng
*首府	shŏufŭ
首富	shŏufù
*首屆	shŏujiè
*首屈一指	shŏuqūyīzhǐ
*首飾	shŏu·shi
*首選	shŏuxuǎn
首映	shŏuyìng
*受保	shòubǎo
受不了	shòu·bùliǎo
受挫	shòucuò
受罰	shòufá
*受訪	shòufǎng
*受僱	shòugù
受害	shòuhài
*受惠	shòuhuì
受賄	shòuhuì
受困	shòukùn
受難	shòunàn
受虐	shòunüè
受聘	shòupìn
受熱	shòurè
受審	shòushĕn
*受損	shòusŭn
*受託	shòutuō
受訓	shòuxùn
*受益	shòuyì
受用	shòuyòng
受孕	shòuyùn
受制	shòuzhì
*受助	shòuzhù
受阻	shòuzŭ
*授權	shòuquán
*授予	shòuyŭ
售	shòu
售貨員	shòuhuòyuán
*售價	shòujià
*售賣	shòumài
售罄	shòuqìng
獸醫	shòuyī
壽	shòu
壽辰	shòuchén
*壽司	shòusī
壽星	shòu·xing
*瘦肉	shòuròu
瘦弱	shòuruò
瘦削	shòuxuē
抒發	shūfā
紓困	shūkùn
紓解	shūjiĕ
倏地	shūdì
*書法	shūfǎ
書房	shūfáng
書稿	shūgǎo
書櫃	shūguì
*書畫	shūhuà
書價	shūjià
*書刊	shūkān
書目	shūmù
書評	shūpíng
書籤	shūqiān
書商	shūshāng
書生	shūshēng
書屋	shūwū
*書院	shūyuàn
書展	shūzhǎn
書桌	shūzhuō
*殊榮	shūróng
梳理	shūlǐ
梳洗	shūxǐ
疏導	shūdǎo
*疏忽	shūhū
疏濬	shūjùn
疏懶	shūlǎn
疏離	shūlí
疏落	shūluò
疏散	shūsǎn
*疏鬆	shūsōng
疏通	shūtōng
疏遠	shūyuǎn
*蔬果	shūguŏ
淑女	shūnǚ
舒	shū
舒緩	shūhuǎn
舒泰	shūtài
樞	shū
樞機	shūjī
*樞紐	shūniŭ
輸電	shūdiàn
輸贏	shūyíng
孰	shú
熟客	shúkè
熟絡	shúluò
熟能生巧	shúnéngshēngqiǎo
熟識	shú·shi
熟睡	shúshuì
熟習	shúxí
贖	shú
暑	shŭ
暑期	shŭqī
署	shŭ
署理	shŭlǐ
*署長	shŭzhǎng
薯片	shŭpiàn
薯條	shŭtiáo
曙光	shŭguāng
述說	shùshuō
術士	shùshì
恕	shù
*漱口	shùkŏu
*數額	shù'é
*數據	shùjù
*數碼	shùmǎ
*數位	shùwèi
豎立	shùlì
豎琴	shùqín
樹叢	shùcóng
樹根	shùgēn
樹膠	shùjiāo
樹梢	shùshāo
樹葉	shùyè
樹蔭	shùyīn
樹枝	shùzhī
刷新	shuāxīn
耍花招	shuǎhuāzhāo
耍賴	shuǎlài
衰	shuāi
衰竭	shuāijié
衰落	shuāiluò
摔倒	shuāidǎo
帥	shuài
*率先	shuàixiān
率性	shuàixìng
率直	shuàizhí
霜花	shuānghuā
*雙邊	shuāngbiān
*雙重	shuāngchóng
雙管齊下	shuāngguǎnqíxià
雙親	shuāngqīn
雙向	shuāngxiàng
雙贏	shuāngyíng
*雙語	shuāngyŭ
爽	shuǎng
爽朗	shuǎnglǎng
水彩	shuǐcǎi
水彩畫	shuǐcǎihuà
水池	shuǐchí
水到渠成	shuǐdàoqúchéng
水道	shuǐdào
水痘	shuǐdòu
水管	shuǐguǎn
水壺	shuǐhú
水花	shuǐhuā
水患	shuǐhuàn
水貨	shuǐhuò
水餃	shuǐjiǎo
*水晶	shuǐjīng
*水警	shuǐjǐng
水坑	shuǐkēng
水療	shuǐliáo
水龍頭	shuǐlóngtóu
水陸	shuǐlù
水路	shuǐlù
水墨畫	shuǐmòhuà
水泡	shuǐpào
水瓶	shuǐpíng
水渠	shuǐqú
水乳交融	shuǐrŭjiāoróng
水塔	shuǐtǎ
水塘	shuǐtáng
水溫	shuǐwēn
水鄉	shuǐxiāng
水壓	shuǐyā
*水域	shuǐyù
*水質	shuǐzhì
水腫	shuǐzhŏng
*水準	shuǐzhŭn
水漬	shuǐzì
稅單	shuìdān
稅法	shuìfǎ
*稅款	shuìkuǎn
*稅率	shuìlǜ
*稅項	shuìxiàng
*稅務	shuìwù
稅則	shuìzé
稅制	shuìzhì
睡袋	shuìdài
睡夢	shuìmèng
順差	shùnchā
順暢	shùnchàng
順從	shùncóng
順道	shùndào
順境	shùnjìng
順理成章	shùnlǐchéngzhāng
順勢	shùnshì
順應	shùnyìng
瞬即	shùnjí
瞬息萬變	shùnxīwànbiàn
說不上	shuō·bùshàng
說服力	shuōfúlì
說教	shuōjiào
說理	shuōlǐ
碩大無朋	shuòdàwúpéng
碩士	shuòshì
司空見慣	sīkōngjiànguàn
司儀	sīyí
*司長	sīzhǎng
*私房	sī·fang
*私家	sījiā
*私家車	sījiāchē
私立	sīlì
私下	sīxià
*私有化	sīyŏuhuà
私語	sīyŭ
思辨	sībiàn
思量	sī·liang
思議	sīyì
絲綢	sīchóu
絲瓜	sīguā
絲絲入扣	sīsīrùkòu
廝殺	sīshā
廝守	sīshŏu
撕	sī
撕裂	sīliè
死黨	sǐdǎng
死灰復燃	sǐhuīfùrán
死鬼	sǐguǐ
死記硬背	sǐjìyìngbèi
死寂	sǐjì
死難	sǐnàn
死人	sǐrén
死傷	sǐshāng
*死亡率	sǐwánglǜ
死亡證	sǐwángzhèng
*死因	sǐyīn
*死者	sǐzhĕ
四分五裂	sìfēnwŭliè
*四季	sìjì
四時	sìshí
四通八達	sìtōngbādá
似是而非	sìshì'érfēi
*寺廟	sìmiào
伺服器	sìfúqì
伺機	sìjī
嗣	sì
飼	sì
祀	sì
肆虐	sìnüè
肆無忌憚	sìwújìdàn
肆意	sìyì
松鼠	sōngshŭ
鬆弛	sōngchí
鬆脆	sōngcuì
鬆軟	sōngruǎn
鬆散	sōngsǎn
鬆懈	sōngxiè
悚然	sŏngrán
慫恿	sŏngyŏng
聳	sŏng
聳立	sŏnglì
送別	sòngbié
訟	sòng
頌	sòng
頌揚	sòngyáng
誦	sòng
誦讀	sòngdú
搜	sōu
搜腸刮肚	sōuchángguādù
搜購	sōugòu
搜救	sōujiù
*搜尋	sōuxún
餿	sōu
酥	sū
酥脆	sūcuì
俗名	súpmíng
俗套	sútào
俗語	súyŭ
*速遞	sùdì
速食	sùshí
素菜	sùcài
素來	sùlái
*素食	sùshí
素養	sùyǎng
宿敵	sùdí
宿命	sùmìng
宿營	sùyíng
宿醉	sùzuì
粟	sù
訴	sù
訴說	sùshuō
塑	sù
塑像	sùxiàng
溯	sù
肅穆	sùmù
肅然起敬	sùránqǐjìng
酸溜溜	suānliūliū
酸痛	suāntòng
*酸性	suānxìng
蒜	suàn
蒜頭	suàntóu
隨波逐流	suíbōzhúliú
隨從	suícóng
隨和	suí·he
隨機應變	suíjīyìngbiàn
隨身	suíshēn
隨身聽	suíshēntīng
*隨時隨地	suíshísuídì
隨心所欲	suíxīnsuŏyù
隨行	suíxíng
隨緣	suíyuán
碎片	suìpiàn
碎石	suìshí
隧道	suìdào
筍	sŭn
損	sŭn
*損毀	sŭnhuǐ
損益	sŭnyì
梭	suō
*縮減	suōjiǎn
縮影	suōyǐng
*所得	suŏdé
所見所聞	suŏjiànsuŏwén
索道	suŏdào
索賠	suŏpéi
*索取	suŏqŭ
索引	suŏyǐn
瑣事	suŏshì
瑣碎	suŏsuì
他日	tārì
塌	tā
拓	tà
拓本	tàbĕn
榻	tà
太極	tàijí
太極拳	tàijíquán
太空船	tàikōngchuán
太空人	tàikōngrén
太空站	tàikōngzhàn
汰	tài
*泰	tài
泰斗	tàidŏu
坍塌	tāntā
貪	tān
貪官	tānguān
貪婪	tānlán
貪睡	tānshuì
*貪污	tānwū
*攤位	tānwèi
彈撥	tánbō
彈劾	tánhé
彈力	tánlì
彈琴	tánqín
彈奏	tánzòu
談吐	tántŭ
壇	tán
曇花	tánhuā
曇花一現	tánhuāyīxiàn
忐忑	tǎntè
坦承	tǎnchéng
坦誠	tǎnchéng
坦然	tǎnrán
*坦言	tǎnyán
炭	tàn
探病	tànbìng
*探訪	tànfǎng
探究	tànjiū
探險	tànxiǎn
探尋	tànxún
探知	tànzhī
嘆為觀止	tànwéiguānzhǐ
*湯匙	tāngchí
湯圓	tāngyuán
唐樓	tánglóu
唐突	tángtū
糖果	tángguŏ
*糖尿病	tángniàobìng
堂弟	tángdì
堂皇	tánghuáng
堂姐	tángjiĕ
堂妹	tángmèi
堂兄	tángxiōng
淌	tǎng
滔滔	tāotāo
濤	tāo
逃遁	táodùn
逃犯	táofàn
逃離	táolí
逃命	táomìng
逃難	táonàn
逃脫	táotuō
逃亡	táowáng
逃之夭夭	táozhīyāoyāo
桃花	táohuā
桃仁	táorén
桃樹	táoshù
淘	táo
淘金	táojīn
淘米	táomǐ
淘氣	táoqì
淘氣鬼	táoqìguǐ
淘洗	táoxǐ
*陶瓷	táocí
陶罐	táoguàn
陶器	táoqì
陶藝	táoyì
陶俑	táoyŏng
陶醉	táozuì
討好	tǎohǎo
討價還價	tǎojiàhuánjià
*套餐	tàocān
套房	tàofáng
套件	tàojiàn
套票	tàopiào
套取	tàoqŭ
套裝	tàozhuāng
特備	tèbèi
*特惠	tèhuì
特輯	tèjí
特技	tèjì
特價	tèjià
特刊	tèkān
特派	tèpài
*特區	tèqū
*特首	tèshŏu
特寫	tèxiĕ
特許	tèxŭ
特邀	tèyāo
特約	tèyuē
*特質	tèzhì
疼愛	téng'ài
騰飛	téngfēi
藤	téng
剔除	tīchú
踢球	tīqiú
梯	tī
梯級	tījí
提款機	tíkuǎnjī
提琴	tíqín
提神	tíshén
*提示	tíshì
*提問	tíwèn
提攜	tíxié
提心吊膽	tíxīndiàodǎn
*提早	tízǎo
題詞	tící
題贈	tízèng
啼	tí
啼笑皆非	tíxiàojiēfēi
蹄	tí
體察	tǐchá
*體能	tǐnéng
體魄	tǐpò
體弱	tǐruò
體態	tǐtài
體味	tǐwèi
體溫計	tǐwēnjì
體形	tǐxíng
體型	tǐxíng
體恤	tǐxù
體液	tǐyè
剃	tì
剃刀	tìdāo
替身	tìshēn
天長地久	tiānchángdìjiŭ
天帝	tiāndì
天方夜譚	tiānfāngyètán
天賦	tiānfù
天花	tiānhuā
天花板	tiānhuābǎn
天荒地老	tiānhuāngdìlǎo
天機	tiānjī
天際	tiānjì
天籟	tiānlài
天理	tiānlǐ
天亮	tiānliàng
天倫	tiānlún
天馬行空	tiānmǎxíngkōng
天明	tiānmíng
天南地北	tiānnándìbĕi
*天橋	tiānqiáo
天壤	tiānrǎng
天時	tiānshí
*天使	tiānshǐ
*天堂	tiāntáng
天性	tiānxìng
天旋地轉	tiānxuándìzhuàn
天涯	tiānyá
天衣無縫	tiānyīwúfèng
天意	tiānyì
天淵	tiānyuān
天災	tiānzāi
天職	tiānzhí
天子	tiānzǐ
*添加	tiānjiā
添加劑	tiānjiājì
添置	tiānzhì
*田徑	tiánjìng
田螺	tiánluó
田園	tiányuán
恬靜	tiánjìng
甜點	tiándiǎn
甜酒	tiánjiŭ
甜美	tiánmĕi
甜蜜	tiánmì
*甜品	tiánpǐn
甜絲絲	tiánsīsī
填報	tiánbào
填寫	tiánxiĕ
挑食	tiāoshí
挑剔	tiāo·ti
條碼	tiáomǎ
調撥	tiáobō
調羹	tiáogēng
調酒	tiáojiŭ
調控	tiáokòng
調理	tiáolǐ
調料	tiáoliào
*調配	tiáopèi
調皮	tiáopí
調皮鬼	tiáopíguǐ
調適	tiáoshì
調停	tiáotíng
*調味	tiáowèi
調校	tiáojiào
調勻	tiáoyún
調製	tiáozhì
眺望	tiàowàng
跳板	tiàobǎn
跳高	tiàogaō
*跳繩	tiàoshéng
跳蚤	tiào·zao
貼切	tiēqiè
貼身	tiēshēn
貼現	tiēxiàn
貼心	tiēxīn
帖	tiĕ
鐵板	tiĕbǎn
鐵觀音	tiĕguānyīn
鐵欄	tiĕlán
鐵閘	tiĕzhá
鐵質	tiĕzhì
帖	tiè
聽從	tīngcóng
聽說	tīngshuō
聽聞	tīngwén
廳堂	tīngtáng
廷	tíng
庭院	tíngyuàn
亭	tíng
*停車	tíngchē
停放	tíngfàng
停工	tínggōng
*停機	tíngjī
停機坪	tíngjīpíng
停刊	tíngkān
停靠	tingkào
停課	tíngkè
停賽	tíngsài
停駛	tíngshǐ
停歇	tíngxiē
停站	tíngzhàn
停職	tíngzhí
停滯	tíngzhì
挺身	tǐngshēn
艇	tǐng
*通報	tōngbào
通暢	tōngchàng
*通車	tōngchē
通達	tōngdá
通讀	tōngdú
*通告	tōnggào
通關	tōngguān
通話	tōnghuà
通貨	tōnghuò
通緝	tōngjī
通氣	tōngqì
*通俗	tōngsú
通天	tōngtiān
通透	tōngtòu
通宵	tōngxiāo
通曉	tōngxiǎo
通心粉	tōngxīnfĕn
通行	tōngxíng
通行證	tōngxíngzhèng
*通脹	tōngzhàng
*同步	tóngbù
同窗	tóngchuāng
同居	tóngjū
同僚	tóngliáo
同鄉	tóngxiāng
同心協力	tóngxīnxiélì
同性	tóngxìng
*同性戀	tóngxìngliàn
*同業	tóngyè
*同一	tóngyī
銅臭	tóngchòu
銅牌	tóngpái
銅器	tóngqì
銅錢	tóngqián
銅像	tóngxiàng
銅鐘	tóngzhōng
童	tóng
童軍	tóngjūn
童心	tóngxīn
童真	tóngzhēn
童裝	tóngzhuāng
瞳孔	tóngkŏng
捅	tŏng
*統籌	tŏngchóu
統領	tŏnglǐng
痛楚	tòngchŭ
痛定思痛	tòngdìngsītòng
痛風	tòngfēng
痛擊	tòngjī
痛心	tongxīn
痛心疾首	tòngxīnjíshŏu
偷	tōu
偷渡	tōudù
偷懶	tōulǎn
偷取	tōuqŭ
偷襲	tōuxí
偷閒	tōuxián
*投保	tóubǎo
投奔	tóubèn
*投放	tóufàng
投寄	tóujì
投考	tóukǎo
*投票	tóupiào
投票權	tóupiàoquán
投契	tóuqì
投射	tóushè
投身	tóushēn
投宿	tóusù
*投訴	tóusù
投胎	tóutāi
投影	tóuyǐng
投注	tóuzhù
頭等	tóudĕng
頭昏腦脹	tóuhūnnǎozhàng
頭皮	tóupí
頭破血流	tóupòxuèliú
頭疼	tóuténg
頭條	tóutiáo
*頭痛	tóutòng
頭頭是道	tóutóushìdào
頭銜	tóuxián
頭緒	tóuxù
頭暈	tóuyūn
*透明度	tòumíngdù
透氣	tòuqì
透視	tòushì
透析	tòuxī
*透支	tòuzhī
凸顯	tūxiǎn
禿子	tū·zi
*突發	tūfā
突飛猛進	tūfēimĕngjìn
突起	tūqǐ
突如其來	tūrúqílái
突圍	tūwéi
突襲	tūxí
徒步	túbù
徒勞	túláo
徒勞無功	túláowúgōng
徒然	túrán
途	tú
途人	túrén
塗料	túliào
塗抹	túmŏ
屠	tú
屠宰	túzǎi
圖解	tújiĕ
*圖片	túpiàn
圖騰	túténg
圖文並茂	túwénbìngmào
圖樣	túyàng
圖章	túzhāng
土產	tŭchǎn
土豆	tŭdòu
土生土長	tŭshēngtŭzhǎng
土著	tŭzhù
吐露	tŭlù
吐痰	tŭtán
湍急	tuānjí
團拜	tuánbài
*團隊	tuánduì
團圓	tuányuán
推崇	tuīchóng
推斷	tuīduàn
*推介	tuījiè
推拿	tuīná
推敲	tuīqiāo
推搪	tuītáng
推想	tuīxiǎng
推卸	tuīxiè
推移	tuīyí
*推展	tuīzhǎn
頹敗	tuíbài
頹廢	tuífèi
頹勢	tuíshì
退股	tuìgŭ
*退還	tuìhuán
退回	tuìhuí
退款	tuìkuǎn
退票	tuìpiào
退讓	tuìràng
退熱	tuìrè
退燒	tuìshāo
退守	tuìshŏu
退縮	tuìsuō
退席	tuìxí
退下	tuìxià
退休金	tuìxiūjīn
退學	tuìxué
退役	tuìyì
退隱	tuìyǐn
褪	tuì
褪色	tuìshǎi
蛻	tuì
蛻變	tuìbiàn
吞	tūn
吞併	tūnbìng
吞噬	tūnshì
吞吐	tūntŭ
吞雲吐霧	tūnyúntŭwù
囤	tún
囤積	túnjī
豚	tún
拖把	tuōbǎ
拖累	tuōlĕi
拖泥帶水	tuōnídàishuǐ
*拖欠	tuōqiàn
拖鞋	tuōxié
*託管	tuōguǎn
託運	tuōyùn
脫軌	tuōguǐ
脫節	tuōjié
脫臼	tuōjiù
脫身	tuōshēn
脫手	tuōshŏu
脫水	tuōshuǐ
脫俗	tuōsú
脫穎而出	tuōyǐng'érchū
駝	tuó
鴕鳥	tuóniǎo
妥	tuŏ
*妥當	tuŏ·dang
*妥善	tuŏshàn
妥貼	tuŏtiē
拓	tuò
*拓展	tuòzhǎn
唾沫	tuò·mo
唾手可得	tuòshŏukĕdé
挖苦	wā·ku
蛙	wā
窪	wā
瓦礫	wǎlì
瓦片	wǎpiàn
*外幣	wàibì
外訪	wàifǎng
*外公	wàigōng
*外觀	wàiguān
*外國人	wàiguórén
外號	wàihào
*外籍	wàijí
外景	wàijǐng
外殼	wàiké
外勞	wàiláo
外貌	wàimào
外聘	wàipìn
*外婆	wàipó
外勤	wàiqín
外人	wàirén
外套	wàitào
外銷	wàixiāo
外泄	wàixiè
外星人	wàixīngrén
外型	wàixíng
外衣	wàiyī
外遇	wàiyù
外援	wàiyuán
外債	wàizhài
外祖父	wàizŭfù
外祖母	wàizŭmŭ
蜿蜒	wānyán
豌豆	wāndòu
彎腰	wānyāo
灣	wān
丸	wán
完好	wánhǎo
*完結	wánjié
完滿	wánmǎn
玩樂	wánlè
玩偶	wán'ŏu
玩耍	wánshuǎ
玩物	wánwù
玩物喪志	wánwùsàngzhì
玩意兒	wányìr
頑疾	wánjí
頑劣	wánliè
宛如	wǎnrú
婉約	wǎnyuē
婉轉	wǎnzhuǎn
挽回	wǎnhuí
挽留	wǎnliú
晚安	wǎn'ān
晚輩	wǎnbèi
*晚餐	wǎncān
晚間	wǎnjiān
晚膳	wǎnshàn
晚霞	wǎnxiá
*晚宴	wǎnyàn
萬不得已	wànbùdéyǐ
萬分	wànfēn
萬花筒	wànhuātŏng
萬能	wànnéng
萬年	wànnián
萬全	wànquán
萬事	wànshì
萬無一失	wànwúyīshī
萬物	wànwù
萬眾	wànzhòng
萬紫千紅	wànzǐqiānhóng
腕	wàn
亡魂	wánghún
王后	wánghòu
*王子	wángzǐ
往常	wǎngcháng
*往返	wǎngfǎn
*往後	wǎnghòu
往昔	wǎngxī
枉	wǎng
枉費	wǎngfèi
網吧	wǎngbā
網點	wǎngdiǎn
*網路	wǎnglù
網羅	wǎngluó
網球	wǎngqiú
*網頁	wǎngyè
網友	wǎngyŏu
*網站	wǎngzhàn
*網址	wǎngzhǐ
*網主	wǎngzhŭ
妄想	wàngxiǎng
忘情	wàngqíng
忘我	wàngwŏ
望子成龍	wàngzǐchénglóng
旺市	wàngshì
危	wēi
危殆	wēidài
危及	wēijí
危急	wēijí
危言聳聽	wēiyánsŏngtīng
危重	wēizhòng
威	wēi
威風	wēifēng
威嚇	wēihè
威嚴	wēiyán
微薄	wēibó
微不足道	wēibùzúdào
微風	wēifēng
微服	wēifú
微量	wēiliàng
微妙	wēimiào
微型	wēixíng
巍峨	wēi'é
為所欲為	wéisuŏyùwéi
*唯一	wéiyī
惟獨	wéidú
惟有	wéiyŏu
維	wéi
維他命	wéitāmìng
維繫	wéixì
*圍村	wéicūn
圍堵	wéidŭ
圍觀	wéiguān
圍巾	wéijīn
圍困	wéikùn
*圍牆	wéiqiáng
圍裙	wéiqún
圍嘴兒	wéizuǐr
違	wéi
*違規	wéiguī
違禁	wéijìn
*違例	wéilì
違約	wéiyuē
尾部	wĕibù
尾聲	wĕishēng
尾站	wĕizhàn
委	wĕi
*委派	wĕipài
*委任	wĕirèn
委身	wĕishēn
委婉	wĕiwǎn
萎	wĕi
萎縮	wĕisuō
偉	wĕi
*偽造	wĕizào
偽證	wĕizhèng
偽裝	wĕizhuāng
未嘗	wèicháng
未婚	wèihūn
未幾	wèijǐ
未雨綢繆	wèiyŭchóumóu
味精	wèijīng
*味覺	wèijué
位居	wèijū
畏	wèi
畏縮	wèisuō
胃口	wèikŏu
胃炎	wèiyán
胃液	wèiyè
蔚藍	wèilán
蔚然	wèirán
蔚然成風	wèiránchéngfēng
衛冕	wèimiǎn
溫飽	wēnbǎo
溫差	wēnchā
溫床	wēnchuáng
溫情	wēnqíng
*溫泉	wēnquán
溫熱	wēnrè
溫潤	wēnrùn
溫室	wēnshì
溫婉	wēnwǎn
溫文爾雅	wēnwén'ĕryǎ
*溫習	wēnxí
*溫馨	wēnxīn
溫煦	wēnxù
*文本	wénbĕn
文筆	wénbǐ
文稿	wéngǎo
文火	wénhuŏ
文具	wénjù
*文科	wénkē
*文憑	wénpíng
*文書	wénshū
文體	wéntǐ
文藝片	wényìpiàn
文娛	wényú
文員	wényuán
文職	wénzhí
文縐縐	wénzhōuzhōu
紋風不動	wénfēngbùdòng
紋理	wénlǐ
紋飾	wénshì
蚊	wén
*聞名	wénmíng
吻合	wĕnhé
紊亂	wĕnluàn
*穩步	wĕnbù
*穩固	wĕngù
*穩健	wĕnjiàn
*穩妥	wĕntuŏ
穩重	wĕnzhòng
問鼎	wèndǐng
*問卷	wènjuàn
問心無愧	wènxīnwúkuì
翁	wēng
嗡	wēng
喔	wō
窩心	wōxīn
我行我素	wŏxíngwŏsù
臥底	wòdǐ
斡旋	wòxuán
污	wū
污點	wūdiǎn
污垢	wūgòu
*污水	wūshuǐ
烏	wū
烏黑	wūhēi
烏龍茶	wūlóngchá
烏紗	wūshā
屋村	wūcūn
*屋頂	wūdǐng
屋脊	wūjǐ
屋檐	wūyán
*屋宇	wūyŭ
毋	wú
毋庸置疑	wúyōngzhìyí
無常	wúcháng
無敵	wúdí
無獨有偶	wúdúyŏu'ŏu
無端	wúduān
無妨	wúfáng
無辜	wúgū
無故	wúgù
無關痛癢	wúguāntòngyǎng
無花果	wúhuāguŏ
無悔	wúhuǐ
無際	wújì
無間	wújiàn
無盡	wújìn
無拘無束	wújūwúshù
無可厚非	wúkĕhòufēi
無孔不入	wúkŏngbùrù
無賴	wúlài
無理	wúlǐ
無理取鬧	wúlǐqŭnào
無禮	wúlǐ
*無聊	wúliáo
無名指	wúmíngzhǐ
*無奈	wúnài
無能	wúnéng
無能為力	wúnéngwéilì
無窮無盡	wúqióngwújìn
無時無刻	wúshíwúkè
無視	wúshì
無私	wúsī
無所不在	wúsuŏbùzài
無所適從	wúsuŏshìcóng
*無所謂	wúsuŏwèi
無微不至	wúwēibùzhì
無畏	wúwèi
無謂	wúwèi
無誤	wúwù
無遺	wúyí
無暇	wúxiá
無瑕	wúxiá
無懈可擊	wúxièkĕjī
無心	wúxīn
無須	wúxū
*無需	wúxū
無言	wúyán
無恙	wúyàng
無益	wúyì
無異	wúyì
無與倫比	wúyŭlúnbǐ
無緣	wúyuán
無助	wúzhù
五光十色	wŭguāngshísè
五花八門	wŭhuābāmén
五行	wŭxíng
伍	wŭ
午	wŭ
*午餐	wŭcān
午飯	wŭfàn
午間	wŭjiān
午膳	wŭshàn
午睡	wŭshuì
午宴	wŭyàn
忤逆	wŭnì
武功	wŭgōng
武火	wŭhuŏ
武生	wŭshēng
武士	wŭshì
*武術	wŭshù
武俠	wŭxiá
武俠片	wŭxiápiàn
武藝	wŭyì
舞伴	wŭbàn
舞弊	wŭbì
舞步	wŭbù
舞池	wŭchí
舞動	wŭdòng
舞迷	wŭmí
舞曲	wŭqŭ
舞文弄墨	wŭwénnòngmò
舞姿	wŭzī
嫵媚	wŭmèi
物產	wùchǎn
*物件	wùjiàn
*物料	wùliào
*物流	wùliú
*物色	wùsè
*物業	wùyè
物證	wùzhèng
悟	wù
*務求	wùqiú
務實	wùshí
*誤導	wùdǎo
夕	xī
夕陽	xīyáng
西紅柿	xīhóngshì
西樂	xīyuè
西裝	xīzhuāng
吸管	xīguǎn
*吸納	xīnà
昔	xī
*昔日	xīrì
惜	xī
惜別	xībié
唏噓	xīxū
稀薄	xībó
稀飯	xīfàn
稀奇	xīqí
稀釋	xīshì
稀疏	xīshū
稀有	xīyŏu
*息率	xīlǜ
*息息相關	xīxīxiāngguān
熄	xī
熄火	xīhuŏ
悉	xī
悉數	xīshŭ
悉數	xīshù
悉心	xīxīn
蟋蟀	xīshuài
犀利	xīlì
溪	xī
溪流	xīliú
熙來攘往	xīláirǎngwǎng
蜥蜴	xīyì
嬉戲	xīxì
嬉笑	xīxiào
嬉笑怒罵	xīxiàonùmà
膝	xī
膝蓋	xīgài
席捲	xíjuǎn
習以為常	xíyǐwéicháng
習字	xízì
習作	xízuò
襲	xí
洗擦	xǐcā
洗耳恭聽	xǐ'ĕrgōngtīng
洗禮	xǐlǐ
*洗手	xǐshŏu
*洗手間	xǐshŏujiān
洗刷	xǐshuā
洗心革面	xǐxīngémiàn
洗衣粉	xǐyīfĕn
洗濯	xǐzhuó
喜出望外	xǐchūwàngwài
喜好	xǐhào
喜氣洋洋	xǐqìyángyáng
喜慶	xǐqìng
喜宴	xǐyàn
細密	xìmì
細嫩	xìnèn
*細膩	xìnì
細碎	xìsuì
細微	xìwēi
*細則	xìzé
隙	xì
戲班	xìbān
戲服	xìfú
戲劇性	xìjùxìng
戲碼	xìmǎ
戲弄	xìnòng
*戲院	xìyuàn
呷	xiā
瞎扯	xiāchĕ
瞎子	xiā·zi
蝦米	xiā·mi
蝦仁	xiārén
俠	xiá
俠義	xiáyì
狹	xiá
狹長	xiácháng
狹小	xiáxiǎo
遐邇	xiá'ĕr
遐想	xiáxiǎng
瑕疵	xiácī
霞	xiá
轄	xiá
*轄下	xiáxià
下巴	xià·ba
下筆	xiàbǐ
下場	xiàchǎng
下沉	xiàchén
下垂	xiàchuí
下挫	xiàcuò
下等	xiàdĕng
*下跌	xiàdiē
下滑	xiàhuá
下嫁	xiàjià
下流	xiàliú
下棋	xiàqí
下身	xiàshēn
下榻	xiàtà
*下調	xiàtiáo
下限	xiàxiàn
下雪	xiàxuĕ
*下載	xiàzài
下肢	xiàzhī
下墜	xiàzhuì
夏令	xiàlìng
夏令營	xiàlìngyíng
嚇人	xiàrén
仙丹	xiāndān
仙境	xiānjìng
仙子	xiānzǐ
先導	xiāndǎo
先河	xiānhé
先機	xiānjī
先例	xiānlì
先聲奪人	xiānshēngduórén
先兆	xiānzhào
先知	xiānzhī
先祖	xiānzŭ
掀	xiān
*鮮嫩	xiānnèn
*鮮味	xiānwèi
纖	xiān
纖巧	xiānqiǎo
纖瘦	xiānshòu
*纖維素	xiānwéisù
纖細	xiānxì
涎	xián
閒逛	xiánguàng
閒聊	xiánliáo
閒情逸致	xiánqíngyìzhì
閒時	xiánshí
閒談	xiántán
閒暇	xiánxiá
閒逸	xiányì
嫺熟	xiánshú
嫌棄	xiánqì
嫌疑	xiányí
賢	xián
鹹魚	xiányú
蜆	xiǎn
險惡	xiǎn'è
險峻	xiǎnjùn
險勝	xiǎnshèng
險要	xiǎnyào
鮮見	xiǎnjiàn
鮮有	xiǎnyŏu
顯赫	xiǎnhè
顯示器	xiǎnshìqì
顯眼	xiǎnyǎn
*限額	xiàn'é
限價	xiànjià
限量	xiànliàng
*限期	xiànqī
*現鈔	xiànchāo
現貨	xiànhuò
現時	xiànshí
現職	xiànzhí
陷阱	xiànjǐng
餡餅	xiànbǐng
*餡料	xiànliào
*線上	xiànshàng
憲章	xiànzhāng
縣市	xiànshì
縣志	xiànzhì
獻藝	xiànyì
相愛	xiāng'ài
相安無事	xiāng'ānwúshì
*相比	xiāngbǐ
*相差	xiāngchā
相稱	xiāngchèn
*相處	xiāngchŭ
*相傳	xiāngchuán
相得益彰	xiāngdéyìzhāng
相仿	xiāngfǎng
相逢	xiāngféng
相符	xiāngfú
相輔相成	xiāngfŭxiāngchéng
相見	xiāngjiàn
相接	xiāngjiē
相距	xiāngjù
相類	xiānglèi
相戀	xiāngliàn
相鄰	xiānglín
相配	xiāngpèi
相容	xiāngróng
*相濡以沫	xiāngrúyǐmò
相若	xiāngruò
相識	xiāngshí
相思	xiāngsī
相提並論	xiāngtíbìnglùn
相像	xiāngxiàng
相形見絀	xiāngxíngjiànchù
相依	xiāngyī
相依為命	xiāngyīwéimìng
相宜	xiāngyí
相異	xiāngyì
相遇	xiāngyù
相約	xiāngyuē
相知	xiāngzhī
相助	xiāngzhù
廂	xiāng
廂房	xiāngfáng
香檳	xiāngbīn
*香草	xiāngcǎo
香醇	xiāngchún
*香脆	xiāngcuì
香火	xiānghuŏ
香蕉	xiāngjiāo
香辣	xiānglà
*香料	xiāngliào
*香爐	xiānglú
香噴噴	xiāngpēnpēn
香片	xiāngpiàn
*香氣	xiāngqì
香軟	xiāngruǎn
香水	xiāngshuǐ
香甜	xiāngtián
*香味	xiāngwèi
鄉土	xiāngtŭ
鄉音	xiāngyīn
鄉鎮	xiāngzhèn
襄助	xiāngzhù
鑲	xiāng
鑲嵌	xiāngqiàn
祥	xiáng
祥和	xiánghé
詳	xiáng
*詳盡	xiángjìn
*詳情	xiángqíng
詳述	xiángshù
翔	xiáng
*享用	xiǎngyòng
*享譽	xiǎngyù
想必	xiǎngbì
想當然	xiǎngdāngrán
巷	xiàng
相機	xiàngjī
相貌	xiàngmào
*相片	xiàngpiàn
橡皮筋兒	xiàngpíjīnr
橡皮艇	xiàngpítǐng
消沉	xiāochén
*消防	xiāofáng
消防員	xiāofángyuán
*消減	xiāojiǎn
消解	xiāojiĕ
消弭	xiāomǐ
消磨	xiāomó
消遣	xiāoqiǎn
消逝	xiāoshì
消瘦	xiāoshòu
消暑	xiāoshŭ
消退	xiāotuì
消閒	xiāoxián
逍遙	xiāoyáo
硝	xiāo
*銷量	xiāoliàng
*小巴	xiǎobā
小吃	xiǎochī
小丑	xiǎochŏu
小調	xiǎodiào
小販	xiǎofàn
小費	xiǎofèi
*小孩兒	xiǎoháir
小品	xiǎopǐn
小氣	xiǎo·qi
小人	xiǎorén
小題大做	xiǎotídàzuò
*小提琴	xiǎotíqín
小腿	xiǎotuǐ
曉	xiǎo
孝	xiào
孝敬	xiàojìng
孝子	xiàozǐ
*哮喘	xiàochuǎn
效法	xiàofǎ
*效能	xiàonéng
效用	xiàoyòng
校報	xiàobào
校風	xiàofēng
*校服	xiàofú
校歌	xiàogē
校工	xiàogōng
校規	xiàoguī
校際	xiàojì
校門	xiàomén
校慶	xiàoqìng
*校舍	xiàoshè
校訓	xiàoxùn
*校友	xiàoyŏu
校友會	xiàoyŏuhuì
*校園	xiàoyuán
笑臉	xiàoliǎn
笑納	xiàonà
笑意	xiàoyì
笑逐顏開	xiàozhúyánkāi
嘯	xiào
歇斯底里	xiēsīdǐlǐ
歇息	xiē·xi
邪惡	xié'è
協	xié
*協辦	xiébàn
協力	xiélì
*協奏曲	xiézòuqŭ
挾	xié
挾持	xiéchí
脅	xié
脅迫	xiépò
*斜坡	xiépō
鞋跟	xiégēn
諧和	xiéhé
諧謔	xiéxuè
諧音	xiéyīn
擷取	xiéqŭ
攜	xié
*攜手	xiéshŏu
寫法	xiĕfǎ
寫生	xiĕshēng
寫實	xiĕshí
*寫意	xiĕyì
寫照	xiĕzhào
*寫字樓	xiĕzìlóu
泄漏	xièlòu
卸	xiè
卸任	xièrèn
屑	xiè
械	xiè
邂逅	xièhòu
蟹黃	xièhuáng
褻瀆	xièdú
謝幕	xièmù
謝意	xièyì
瀉	xiè
心虛	xīnxū
心腸	xīncháng
心地	xīndì
心動	xīndòng
心房	xīnfáng
心扉	xīnfēi
心腹	xīnfù
心花怒放	xīnhuānùfàng
心灰意冷	xīnhuīyìlĕng
心機	xīnjī
心急	xīnjí
心跡	xīnjì
*心經	xīnjīng
心境	xīnjìng
心曠神怡	xīnkuàngshényí
心理學	xīnlǐxué
心領神會	xīnlǐngshénhuì
心路	xīnlù
心滿意足	xīnmǎnyìzú
心軟	xīnruǎn
心聲	xīnshēng
心酸	xīnsuān
心碎	xīnsuì
*心態	xīntài
心疼	xīnténg
心痛	xīntòng
心弦	xīnxián
心心相印	xīnxīnxiāngyìn
心性	xīnxìng
心緒	xīnxù
心眼兒	xīnyǎnr
心儀	xīnyí
*心意	xīnyì
心有餘悸	xīnyŏuyújì
心臟病	xīnzàngbìng
心智	xīnzhì
心醉	xīnzuì
辛	xīn
辛辣	xīnlà
辛勞	xīnláo
辛酸	xīnsuān
新潮	xīncháo
新婚	xīnhūn
新年	xīnnián
*新詩	xīnshī
新秀	xīnxiù
*新增	xīnzēng
薪	xīn
*薪酬	xīnchóu
*薪俸	xīnfèng
*薪金	xīnjīn
薪水	xīn·shuǐ
欣然	xīnrán
欣慰	xīnwèi
欣喜	xīnxǐ
欣欣向榮	xīnxīnxiàngróng
信奉	xìnfèng
信服	xìnfú
信函	xìnhán
信守	xìnshŏu
*信託	xìntuō
信物	xìnwù
信箱	xìnxiāng
*信用卡	xìnyòngkǎ
*信用證	xìnyòngzhèng
*信譽	xìnyù
星辰	xīngchén
*星光	xīngguāng
星羅棋佈	xīngluóqíbù
星相	xīngxiàng
星座	xīngzuò
惺忪	xīngsōng
腥	xīng
興風作浪	xīngfēngzuòlàng
興隆	xīnglóng
興盛	xīngshèng
興衰	xīngshuāi
興亡	xīngwáng
刑警	xíngjǐng
刑期	xíngqī
形形色色	xíngxíngsèsè
形影不離	xíngyǐngbùlí
形制	xíngzhì
*行車	xíngchē
*行程	xíngchéng
行囊	xíngnáng
*行事	xíngshì
行文	xíngwén
行銷	xíngxiāo
行雲流水	xíngyúnliúshuǐ
行之有效	xíngzhīyŏuxiào
行蹤	xíngzōng
醒目	xǐngmù
醒悟	xǐngwù
杏兒	xìngr
杏花	xìnghuā
*杏仁	xìngrén
幸	xìng
幸而	xìng'ér
*幸好	xìnghǎo
幸虧	xìngkuī
幸免	xìngmiǎn
*幸運	xìngyùn
性感	xìnggǎn
*姓氏	xìngshì
興高采烈	xìnggāocǎiliè
興致	xìngzhì
凶兆	xiōngzhào
兇案	xiōng'àn
兇殘	xiōngcán
兇殺	xiōngshā
兇手	xiōngshŏu
兇徒	xiōngtú
兇險	xiōngxiǎn
洶湧	xiōngyŏng
胸部	xiōngbù
胸襟	xiōngjīn
胸圍	xiōngwéi
雄渾	xiónghún
雄健	xióngjiàn
雄踞	xióngjù
雄奇	xióngqí
雄心	xióngxīn
雄性	xióngxìng
熊貓	xióngmāo
休	xiū
休會	xiūhuì
休假	xiūjià
*休憩	xiūqì
*休閒	xiūxián
修補	xiūbŭ
修長	xiūcháng
修道院	xiūdàoyuàn
*修讀	xiūdú
修剪	xiūjiǎn
修女	xiūnǚ
*修葺	xiūqì
修繕	xiūshàn
修身	xiūshēn
修士	xiūshì
修飾	xiūshì
修習	xiūxí
修行	xiū·xíng
修業	xiūyè
羞	xiū
羞怯	xiūqiè
羞辱	xiūrŭ
羞澀	xiūsè
朽	xiŭ
秀	xiù
秀美	xiùmĕi
袖口	xiùkŏu
嗅覺	xiùjué
鏽	xiù
*須要	xūyào
虛構	xūgòu
虛耗	xūhào
虛幻	xūhuàn
*虛假	xūjiǎ
*虛擬	xūnǐ
虛榮	xūróng
虛無飄渺	xūwúpiāomiǎo
噓	xū
栩栩如生	xŭxŭrúshēng
許久	xŭjiŭ
*許可證	xŭkĕzhèng
許諾	xŭnuò
許願	xŭyuàn
旭日	xùrì
序列	xùliè
序幕	xùmù
序曲	xùqŭ
序數	xùshù
敘	xù
敘說	xùshuō
絮	xù
蓄	xù
蓄勢待發	xùshìdàifā
蓄意	xùyì
緒	xù
宣	xuān
宣導	xuāndǎo
宣判	xuānpàn
*宣誓	xuānshì
宣泄	xuānxiè
宣紙	xuānzhǐ
喧賓奪主	xuānbīnduózhŭ
喧嘩	xuānhuá
喧鬧	xuānnào
喧囂	xuānxiāo
玄	xuán
玄關	xuánguān
玄機	xuánjī
旋即	xuánjí
漩渦	xuánwō
懸浮	xuánfú
懸空	xuánkōng
懸殊	xuánshū
選材	xuǎncái
選讀	xuǎndú
選段	xuǎnduàn
*選購	xuǎngòu
選輯	xuǎnjí
選美	xuǎnmĕi
*選民	xuǎnmín
選票	xuǎnpiào
*選取	xuǎnqŭ
選題	xuǎntí
炫耀	xuànyào
眩暈	xuànyùn
旋風	xuànfēng
渲染	xuànrǎn
絢爛	xuànlàn
絢麗	xuànlì
*削減	xuējiǎn
靴	xuē
學費	xuéfèi
學分	xuéfēn
學府	xuéfŭ
*學界	xuéjiè
*學歷	xuélì
*學年	xuénián
學期	xuéqī
學生證	xuéshēngzhèng
學識	xuéshí
*學士	xuéshì
學童	xuétóng
*學位	xuéwèi
學養	xuéyǎng
*學業	xuéyè
學以致用	xuéyǐzhìyòng
*學長	xuézhǎng
*學制	xuézhì
學子	xuézǐ
雪地	xuĕdì
*雪糕	xuĕgāo
雪梨	xuĕlí
雪山	xuĕshān
鱈魚	xuĕyú
血漿	xuèjiāng
血淋淋	xiělínlín
血脈	xuèmài
血糖	xuètáng
血統	xuètŏng
血小板	xuèxiǎobǎn
血腥	xuèxīng
血友病	xuèyŏubìng
血緣	xuèyuán
血脂	xuèzhī
熏	xūn
勳爵	xūnjué
勳章	xūnzhāng
薰	xūn
薰陶	xūntáo
旬	xún
巡	xún
*巡查	xúnchá
*巡迴	xúnhuí
巡禮	xúnlǐ
*巡邏	xúnluó
巡視	xúnshì
*巡遊	xúnyóu
尋常	xúncháng
尋根	xúngēn
尋獲	xúnhuò
尋覓	xúnmì
尋思	xún·si
尋找	xúnzhǎo
循	xún
循規蹈矩	xúnguīdǎojŭ
循例	xúnlì
*循序漸進	xúnxùjiànjìn
循循善誘	xúnxúnshànyòu
汛	xùn
汛期	xùnqī
迅	xùn
迅即	xùnjí
訊	xùn
*訊號	xùnhào
訊問	xùnwèn
*訊息	xùnxī
徇私	xùnsī
殉難	xùnnàn
殉職	xùnzhí
*訓導	xùndǎo
訓令	xùnlìng
訓示	xùnshì
馴	xùn
馴服	xùnfú
遜	xùn
遜色	xùnsè
丫頭	yā·tou
押解	yājiè
押韻	yāyùn
鴨舌帽	yāshémào
壓歲錢	yāsuìqián
壓榨	yāzhà
壓軸	yāzhóu
牙	yá
牙縫	yáfèng
*牙膏	yágāo
牙關	yáguān
*牙科	yákē
牙籤	yáqiān
牙刷	yáshuā
牙醫	yáyī
牙齦	yáyín
牙周病	yázhōubìng
衙門	yá·men
啞	yǎ
啞口無言	yǎkŏuwúyán
啞鈴	yǎlíng
雅	yǎ
雅俗共賞	yǎsúgòngshǎng
雅致	yǎzhì
*亞熱帶	yàrèdài
軋	yà
訝異	yàyì
咽喉	yānhóu
胭脂	yān·zhi
淹	yān
*煙花	yānhuā
煙灰	yānhuī
煙火	yānhuŏ
煙癮	yānyǐn
嫣紅	yānhóng
燕	Yān
延	yán
*延遲	yánchí
延綿	yánmián
延年益壽	yánniányìshòu
延聘	yánpìn
*延期	yánqī
*延誤	yánwù
延展	yánzhǎn
筵席	yánxí
言辭	yáncí
言行	yánxíng
岩壁	yánbì
岩漿	yánjiāng
沿路	yánlù
*沿途	yántú
*沿線	yánxiàn
*沿用	yányòng
*炎熱	yánrè
研讀	yándú
*研發	yánfā
研究員	yánjiūyuán
研究院	yánjiūyuàn
研磨	yánmó
*研討	yántǎo
*研習	yánxí
檐	yán
顏	yán
顏料	yánliào
嚴懲	yánchéng
*嚴謹	yánjǐn
嚴苛	yánkē
嚴守	yánshŏu
嚴正	yánzhèng
鹽水	yánshuǐ
奄奄一息	yǎnyǎnyīxī
掩	yǎn
掩面	yǎnmiàn
衍	yǎn
*衍生	yǎnshēng
眼部	yǎnbù
眼底	yǎndǐ
眼瞼	yǎnjiǎn
眼角	yǎnjiǎo
眼界	yǎnjiè
眼科	yǎnkē
眼眶	yǎnkuàng
眼簾	yǎnlián
眼皮	yǎnpí
眼球	yǎnqiú
眼罩	yǎnzhào
眼珠子	yǎnzhū·zi
*演唱會	yǎnchànghuì
演技	yǎnjì
演練	yǎnliàn
*演習	yǎnxí
*演藝	yǎnyì
儼然	yǎnrán
儼如	yǎnrú
宴	yàn
宴客	yànkè
焰	yàn
厭煩	yànfán
厭倦	yànjuàn
燕	yàn
*燕窩	yànwō
燕子	yàn·zi
*諺語	yànyŭ
艷	yàn
艷麗	yànlì
央求	yāngqiú
*洋蔥	yángcōng
*洋房	yángfáng
洋娃娃	yangwá·wa
洋溢	yángyì
揚長避短	yángchángbìduǎn
揚帆	yángfān
揚聲器	yángshēngqì
揚威	yángwēi
揚言	yángyán
陽剛	yánggāng
*陽曆	yánglì
陽平	yángpíng
陽傘	yángsǎn
陽台	yángtái
陽性	yángxìng
楊柳	yángliŭ
仰慕	yǎngmù
仰望	yǎngwàng
仰望	yǎngwàng
養家餬口	yǎngjiāhúkŏu
養傷	yǎngshāng
養身	yǎngshēn
養生	yǎngshēng
養顏	yǎngyán
癢	yǎng
漾	yàng
夭折	yāozhé
腰果	yāoguŏ
腰斬	yāozhǎn
腰椎	yāozhuī
邀	yāo
邀約	yāoyuē
杳無人煙	yǎowúrényān
搖擺	yáobǎi
搖動	yáodòng
搖滾樂	yáogŭnyuè
搖籃	yáolán
搖錢樹	yáoqiánshù
搖曳	yáoyè
遙控	yáokòng
遙望	yáowàng
遙遙無期	yáoyáowúqī
要衝	yàochōng
*要點	yàodiǎn
要害	yàohài
要訣	yàojué
要命	yàomìng
要塞	yàosài
要員	yàoyuán
要旨	yàozhǐ
藥草	yàocǎo
藥廠	yàochǎng
藥房	yàofáng
*藥劑	yàojì
藥劑師	yàojìshī
藥膳	yàoshàn
藥丸	yàowán
藥效	yàoxiào
藥用	yàoyòng
耀	yào
耀目	yàomù
揶揄	yéyú
椰	yē
椰樹	yēshù
椰汁	yēzhī
椰子	yē·zi
冶	yĕ
野餐	yĕcān
野性	yĕxìng
曳	yè
夜貓子	yèmāo·zi
夜幕	yèmù
夜色	yèsè
夜宵	yèxiāo
夜校	yèxiào
夜總會	yèzŏnghuì
液晶	yèjīng
腋	yè
腋窩	yèwō
葉酸	yèsuān
*業績	yèjì
業已	yèyǐ
*業主	yèzhŭ
*業界	yèjiè
一本正經	yībĕnzhèngjīng
一波三折	yībōsānzhé
一塵不染	yīchénbùrǎn
一觸即發	yīchùjífā
*一代	yīdài
一點兒	yīdiǎnr
一帆風順	yīfānfēngshùn
*一番	yīfān
一飛沖天	yīfēichōngtiān
一鼓作氣	yīgŭzuòqì
*一國兩制	yīguóliǎngzhì
一呼百應	yīhūbǎiyìng
一見如故	yījiànrúgù
一見鍾情	yījiànzhōngqíng
一舉	yījŭ
一舉成名	yījŭchéngmíng
一舉兩得	yījŭliǎngdé
*一刻	yīkè
*一口氣	yīkŏuqì
一覽無遺	yīlǎnwúyí
一勞永逸	yīláoyŏngyì
*一流	yīliú
一馬當先	yīmǎdāngxiān
一脈相承	yīmàixiāngchéng
一門	yīmén
一模一樣	yīmúyīyàng
*一目了然	yīmùliǎorán
一片	yīpiàn
一氣	yīqì
一氣呵成	yīqìhēchéng
一竅不通	yīqiàobùtōng
一清二楚	yīqīng'èrchŭ
一日千里	yīrìqiānlǐ
一如	yīrú
一如既往	yīrújìwǎng
一掃而空	yīsǎo'érkōng
*一身	yīshēn
*一世	yīshì
一視同仁	yīshìtóngrén
*一手	yīshŏu
一絲不苟	yīsībùgŏu
一套	yītào
一條龍	yītiáolóng
*一頭	yītóu
一頭霧水	yītóuwùshuǐ
*一團	yītuán
一網打盡	yīwǎngdǎjìn
一窩蜂	yīwōfēng
一無是處	yīwúshìchù
一無所有	yīwúsuŏyŏu
*一下子	yīxià·zi
一廂情願	yīxiāngqíngyuàn
一言不發	yīyánbùfā
一意孤行	yīyìgūxíng
一飲而盡	yīyǐn'érjìn
一應俱全	yīyīngjùquán
一朝一夕	yīzhāoyīxī
一針見血	yīzhēnjiànxiĕ
*一陣	yīzhèn
一枝獨秀	yīzhīdúxiù
一知半解	yīzhībànjiĕ
衣冠楚楚	yīguānchŭchŭ
衣袋	yīdài
衣櫃	yīguì
衣架	yījià
衣料	yīliào
衣飾	yīshì
衣袖	yīxiù
*衣物	yīwù
衣著	yīzhuó
依存	yīcún
依歸	yīguī
依戀	yīliàn
依稀	yīxī
依循	yīxún
依偎	yīwēi
依依不捨	yīyībùshĕ
*醫護	yīhù
醫科	yīkē
醫師	yīshī
醫學院	yīxuéyuàn
夷	yí
夷為平地	yíwéipíngdì
姨	yí
姨父	yí·fu
姨媽	yímā
胰島素	yídǎosù
胰腺	yíxiàn
宜人	yírén
移步	yíbù
*移交	yíjiāo
*移居	yíjū
移師	yíshī
疑點	yídiǎn
*疑犯	yífàn
疑慮	yílǜ
疑似	yísì
疑團	yítuán
儀表	yíbiǎo
儀容	yíróng
遺存	yícún
遺骸	yíhái
遺害	yíhài
遺跡	yíjì
遺漏	yílòu
遺落	yíluò
遺民	yímín
遺棄	yíqì
遺容	yíróng
遺書	yíshū
遺屬	yíshŭ
遺孀	yíshuāng
*遺體	yítǐ
遺忘	yíwàng
遺物	yíwù
遺言	yíyán
遺照	yízhào
*已故	yǐgù
已婚	yǐhūn
以訛傳訛	yǐ'échuán'é
以貌取人	yǐmàoqŭrén
*以期	yǐqī
以身作則	yǐshēnzuòzé
以牙還牙	yǐyáhuányá
倚靠	yǐkào
倚賴	yǐlài
倚重	yǐzhòng
亦步亦趨	yìbùyìqū
屹立	yìlì
抑	yì
抑或	yìhuò
抑壓	yìyā
抑揚頓挫	yìyángdùncuò
抑鬱	yìyù
抑鬱症	yìyùzhèng
易手	yìshŏu
疫	yì
*疫苗	yìmiáo
*疫情	yìqíng
益蟲	yìchóng
*益處	yì·chù
益智	yìzhì
溢	yì
溢價	yìjià
異彩	yìcǎi
異地	yìdì
異端	yìduān
異國	yìguó
異化	yìhuà
異見	yìjiàn
異軍突起	yìjūntūqǐ
異口同聲	yìkŏutóngshēng
異味	yìwèi
異物	yìwù
異鄉	yìxiāng
異性	yìxìng
異議	yìyì
異域	yìyù
*翌年	yìnián
*翌日	yìrì
逸	yì
*意念	yìniàn
意氣	yìqì
意趣	yìqù
意態	yìtài
意味深長	yìwèishēncháng
*意向	yìxiàng
意向書	yìxiàngshū
*意欲	yìyù
*意願	yìyuàn
意旨	yìzhǐ
憶	yì
義賣	yìmài
義氣	yì·qì
義無反顧	yìwúfǎngù
義正詞嚴	yìzhèngcíyán
*議案	yì'àn
議價	yìjià
議決	yìjué
議論文	yìlùnwén
*議題	yìtí
議席	yìxí
肄業	yìyè
*藝人	yìrén
藝術品	yìshùpǐn
譯本	yìbĕn
因材施教	yīncáishījiào
因數	yīnshù
因循	yīnxún
因由	yīnyóu
因緣	yīnyuán
姻緣	yīnyuán
音符	yīnfú
音量	yīnliàng
音色	yīnsè
音韻	yīnyùn
音質	yīnzhì
殷	yīn
殷切	yīnqiè
殷勤	yīnqín
殷商	yīnshāng
陰沉	yīnchén
陰曆	yīnlì
陰涼	yīnliáng
陰平	yīnpíng
陰險	yīnxiǎn
陰性	yīnxìng
吟	yín
吟唱	yínchàng
吟誦	yínsòng
淫	yín
淫蕩	yíndàng
淫穢	yínhuì
銀河	yínhé
*銀幕	yínmù
*銀牌	yínpái
銀色	yínsè
銀飾	yínshì
銀杏	yínxìng
銀元	yínyuán
引渡	yǐndù
*引發	yǐnfā
*引領	yǐnlǐng
引經據典	yǐnjīngjùdiǎn
*引擎	yǐnqíng
引人入勝	yǐnrénrùshèng
*引入	yǐnrù
引申	yǐnshēn
*引述	yǐnshù
引退	yǐntuì
引文	yǐnwén
引言	yǐnyán
引以為榮	yǐnyǐwéiróng
引證	yǐnzhèng
*引致	yǐnzhì
*飲料	yǐnliào
飲泣	yǐnqì
飲宴	yǐnyàn
*飲用	yǐnyòng
飲用水	yǐnyòngshuǐ
隱伏	yǐnfú
隱含	yǐnhán
隱患	yǐnhuàn
隱晦	yǐnhuì
隱疾	yǐnjí
隱居	yǐnjū
隱沒	yǐnmò
隱私	yǐnsī
隱退	yǐntuì
隱現	yǐnxiàn
隱形	yǐnxíng
隱性	yǐnxìng
隱憂	yǐnyōu
隱喻	yǐnyù
癮	yǐn
印表機	yìnbiǎojī
印發	yìnfā
印花	yìnhuā
印章	yìnzhāng
印證	yìnzhèng
*印製	yìnzhì
*英鎊	Yīngbàng
英才	yīngcái
英尺	yīngchǐ
英傑	yīngjié
英氣	yīngqì
英姿	yīngzī
嬰	yīng
嬰孩	yīnghái
櫻桃	yīng·táo
鸚鵡	yīngwŭ
應屆	yīngjiè
應聲	yīngshēng
應有盡有	yīngyŏujìnyŏu
膺	yīng
罌粟花	yīngsùhuā
迎賓	yíngbīn
*迎合	yínghé
迎擊	yíngjī
迎刃而解	yíngrèn'érjiĕ
迎向	yíngxiàng
盈	yíng
*盈餘	yíngyú
*熒幕	yíngmù
縈繞	yíngrào
螢	yíng
螢火蟲	yínghuŏchóng
*營辦	yíngbàn
營地	yíngdì
營房	yíngfáng
營建	yíngjiàn
營救	yíngjiù
*營運	yíngyùn
*營造	yíngzào
蠅	yíng
贏	yíng
贏利	yínglì
贏取	yíngqŭ
影帶	yǐngdài
影帝	yǐngdì
影碟	yǐngdié
影后	yǐnghòu
影迷	yǐngmí
影評	yǐngpíng
影射	yǐngshè
*影視	yǐngshì
*影像	yǐngxiàng
影星	yǐngxīng
影印	yǐngyìn
影印機	yǐngyìnjī
影院	yǐngyuàn
影展	yǐngzhǎn
映襯	yìngchèn
映入眼簾	yìngrùyǎnlián
映射	yìngshè
映照	yìngzhào
硬幣	yìngbì
硬朗	yìng·lang
硬性	yìngxìng
*應變	yìngbiàn
應對	yìngduì
應和	yìnghè
應急	yìngjí
應考	yìngkǎo
應聲	yìngshēng
應市	yìngshì
應試	yìngshì
應驗	yìngyàn
應運而生	yìngyùn'érshēng
應戰	yìngzhàn
應徵	yìngzhēng
傭工	yōnggōng
傭人	yōngrén
雍容	yōngróng
*擁抱	yōngbào
擁戴	yōngdài
臃腫	yōngzhŏng
永垂不朽	yŏngchuíbùxiŭ
泳	yŏng
泳灘	yŏngtān
泳衣	yŏngyī
勇	yŏng
勇往直前	yŏngwǎngzhíqián
用功	yònggōng
*用具	yòngjù
*用料	yòngliào
用膳	yòngshàn
用心	yòngxīn
用心良苦	yòngxīnliángkŭ
*用語	yòngyŭ
用字	yòngzì
*佣金	yòngjīn
幽暗	yōu'àn
幽靈	yōulíng
幽情	yōuqíng
幽香	yōuxiāng
幽雅	yōuyǎ
悠長	yōucháng
悠然	yōurán
*悠閒	yōuxián
悠揚	yōuyáng
悠遊	yōuyóu
憂	yōu
憂愁	yōuchóu
憂患	yōuhuàn
*憂慮	yōulǜ
憂慼	yōuqī
憂傷	yōushāng
憂心	yōuxīn
憂怨	yōuyuàn
優柔寡斷	yōuróuguǎduàn
優厚	yōuhòu
*優化	yōuhuà
優劣	yōuliè
優閒	yōuxián
*優雅	yōuyǎ
*優異	yōuyì
由衷	yóuzhōng
油門	yóumén
油膩	yóunì
油條	yóutiáo
油污	yóuwū
油煙	yóuyān
郵	yóu
郵包	yóubāo
郵差	yóuchāi
郵戳	yóuchuō
*郵遞	yóudì
郵遞員	yóudìyuán
郵費	yóufèi
郵件	yóujiàn
郵局	yóujú
*郵輪	yóulún
郵品	yóupǐn
郵筒	yóutŏng
郵務	yóuwù
郵箱	yóuxiāng
*郵政	yóuzhèng
游離	yóulí
游手好閒	yóushŏuhàoxián
游泳池	yóuyŏngchí
遊船	yóuchuán
遊蕩	yóudàng
遊記	yóujì
*遊客	yóukè
遊廊	yóuláng
遊樂	yóulè
*遊樂場	yóulèchǎng
遊歷	yóulì
遊輪	yóulún
*遊人	yóurén
遊說	yóushuì
遊艇	yóutǐng
遊玩	yóuwán
遊戲機	yóuxìjī
*遊學	yóuxué
猶疑	yóuyí
魷魚	yóuyú
黝黑	yŏuhēi
友愛	yŏu'ài
*友善	yŏushàn
友校	yŏuxiào
有害	yŏuhài
有理	yŏulǐ
有目共睹	yŏumùgòngdŭ
有板有眼	yŏubǎnyŏuyǎn
有點	yŏudiǎn
*有賴	yŏulài
有生之年	yŏushēngzhīnián
有聲有色	yŏushēngyŏusè
*有數	yŏushù
有條不紊	yŏutiáobùwĕn
*有望	yŏuwàng
有致	yŏuzhì
幼蟲	yòuchóng
幼嫩	yòunèn
幼稚	yòuzhì
幼稚園	yòuzhìyuán
佑	yòu
柚子	yòu·zi
誘	yòu
誘發	yòufā
誘使	yòushǐ
誘因	yòuyīn
迂	yū
迂腐	yūfŭ
迂迴	yūhuí
淤	yū
淤泥	yūní
淤塞	yūsè
瘀血	yūxuè
魚翅	yúchì
魚刺	yúcì
魚餌	yú'ĕr
魚缸	yúgāng
魚鱗	yúlín
魚子醬	yúzǐjiàng
漁船	yúchuán
漁村	yúcūn
漁夫	yúfū
漁港	yúgǎng
愉悅	yúyuè
*逾	yú
逾期	yúqī
瑜伽	yújiā
愚	yú
愚不可及	yúbùkĕjí
愚弄	yúnòng
虞	yú
*餘額	yú'é
餘光	yúguāng
餘生	yúshēng
餘暇	yúxiá
*餘下	yúxià
餘韻	yúyùn
宇航	yŭháng
宇航員	yŭhángyuán
羽翼	yŭyì
雨季	yŭjì
雨傘	yŭsǎn
雨天	yŭtiān
與日俱增	yŭrìjùzēng
與世長辭	yŭshìchángcí
語境	yŭjìng
語錄	yŭlù
語速	yŭsù
玉器	yùqì
芋頭	yù·tou
浴	yù
浴缸	yùgāng
喻	yù
諭	yù
寓	yù
寓所	yùsuŏ
寓意	yùyì
遇難	yùnàn
御	yù
御用	yùyòng
預	yù
預感	yùgǎn
預告	yùgào
*預計	yùjì
預警	yùjǐng
*預科	yùkē
*預留	yùliú
預謀	yùmóu
預習	yùxí
*預約	yùyüē
豫	yù
獄	yù
譽	yù
鬱	yù
鬱結	yùjié
籲	yù
冤	yuān
冤家	yuān·jia
淵	yuān
淵博	yuānbó
淵源	yuānyuán
鴛鴦	yuān·yāng
元旦	yuándàn
元老	yuánlǎo
元宵	yuánxiāo
元宵節	Yuánxiāojié
*原本	yuánbĕn
原產	yuánchǎn
*原產地	yuánchǎndì
*原創	yuánchuàng
原封不動	yuánfēngbùdòng
*原告	yuángào
原籍	yuánjí
原貌	yuánmào
*原著	yuánzhù
源流	yuánliú
*源頭	yuántóu
源遠流長	yuányuǎnliúcháng
*源自	yuánzì
*員工	yuángōng
圓號	yuánhào
*圓滿	yuánmǎn
圓盤	yuánpán
圓潤	yuánrùn
圓舞曲	yuánwŭqŭ
圓形	yuánxíng
圓柱	yuánzhù
援	yuán
援手	yuánshŏu
援引	yuányǐn
園地	yuándì
園丁	yuándīng
園圃	yuánpŭ
園藝	yuányì
緣份	yuánfèn
遠古	yuǎngŭ
*遠離	yuǎnlí
遠眺	yuǎntiào
遠望	yuǎnwàng
遠洋	yuǎnyáng
遠征	yuǎnzhēng
*遠足	yuǎnzú
*苑	yuàn
怨恨	yuànhèn
怨氣	yuànqì
怨聲載道	yuànshēngzàidào
怨言	yuànyán
*院校	yuànxiào
約定	yuēdìng
約見	yuējiàn
約束力	yuēshùlì
月餅	yuè·bing
月季	yuè·jì
月刊	yuèkān
月曆	yuèlì
月食	yuèshí
*月台	yuètái
*月薪	yuèxīn
岳	yuè
岳父	yuèfù
岳母	yuèmŭ
悅	yuè
悅耳	yuè'ĕr
悅目	yuèmù
*粵劇	Yuèjù
*粵語	Yuèyŭ
越位	yuèwèi
越野	yuèyĕ
越野車	yuèyĕchē
樂迷	yuèmí
樂手	yuèshŏu
*樂團	yuètuán
樂譜	yuèpŭ
樂師	yuèshī
*樂壇	yuètán
*樂章	yuèzhāng
閱	yuè
閱覽	yuèlǎn
閱歷	yuèlì
躍動	yuèdòng
躍然紙上	yuèránzhǐshàng
躍升	yuèshēng
躍躍欲試	yuèyuèyùshì
暈	yūn
暈倒	yūndǎo
暈厥	yūnjué
暈眩	yūnxuàn
芸芸眾生	yúnyúnzhòngshēng
雲層	yúncéng
雲集	yúnjí
雲梯	yúntī
雲霞	yúnxiá
允	yŭn
允諾	yŭnnuò
孕	yùn
*孕婦	yùnfù
運籌	yùnchóu
運籌帷幄	yùnchóuwéiwò
運抵	yùndǐ
運動場	yùndòngchǎng
運動服	yùndòngfú
運動鞋	yùndòngxié
運費	yùnfèi
運河	yùnhé
*運送	yùnsòng
*運營	yùnyíng
運載	yùnzài
*運作	yùnzuò
暈	yùn
蘊	yùn
蘊含	yùnhán
韻律	yùnlǜ
韻味	yùnwèi
雜草叢生	zácǎocóngshēng
雜費	záfèi
雜貨	záhuò
*雜技	zájì
雜亂	záluàn
雜物	záwù
雜務	záwù
災	zāi
災禍	zāihuò
災民	zāimín
災區	zāiqū
栽種	zāizhòng
宰	zǎi
*再度	zàidù
再會	zàihuì
再接再厲	zàijiēzàilì
再生	zàishēng
再造	zàizào
再者	zàizhĕ
在乎	zài·hu
在世	zàishì
在所不辭	zàisuŏbùcí
在望	zàiwàng
*在下	zàixià
在學	zàixué
*在職	zàizhí
*在座	zàizuò
載歌載舞	zàigēzàiwŭ
載體	zàitǐ
載譽	zàiyù
載運	zàiyùn
暫緩	zànhuǎn
*暫停	zàntíng
贊	zàn
讚不絕口	zànbùjuékŏu
*讚賞	zànshǎng
讚許	zànxŭ
讚譽	zànyù
糟糕	zāogāo
鑿	záo
早安	zǎo'ān
早餐	zǎocān
早操	zǎocāo
*早年	zǎonián
早熟	zǎoshú
棗	zǎo
澡	zǎo
造船	zàochuán
造訪	zàofǎng
造福	zàofú
造詣	zàoyì
燥	zào
躁	zào
責	zé
責罵	zémà
責難	zénàn
責任心	zérènxīn
嘖嘖	zézé
嘖嘖稱奇	zézéchēngqí
澤	zé
澤國	zéguó
擇	zé
仄	zè
賊人	zéirén
怎地	zĕn·di
增補	zēngbŭ
*增幅	zēngfú
增廣	zēngguǎng
*增設	zēngshè
*增長率	zēngzhǎnglǜ
*增值	zēngzhí
贈	zèng
贈予	zèngyŭ
渣滓	zhā·zǐ
軋	zhá
閘	zhá
閘口	zhákŏu
閘門	zhámén
眨眼	zhǎyǎn
詐	zhà
*詐騙	zhàpiàn
榨	zhà
摘錄	zhāilù
摘取	zhāiqŭ
*摘要	zhāiyào
齋	zhāi
宅	zhái
窄幅	zhǎifú
債款	zhàikuǎn
債權	zhàiquán
*債權人	zhàiquánrén
*債券	zhàiquàn
債主	zhàizhŭ
占卜	zhānbŭ
沾染	zhānrǎn
沾沾自喜	zhānzhānzìxǐ
氈	zhān
瞻	zhān
展板	zhǎnbǎn
展館	zhǎnguǎn
展會	zhǎnhuì
*展覽館	zhǎnlǎnguǎn
展露	zhǎnlù
*展品	zhǎnpǐn
展期	zhǎnqī
*展望	zhǎnwàng
展位	zhǎnwèi
展銷	zhǎnxiāo
輾轉	zhǎnzhuǎn
輾轉反側	zhǎnzhuǎnfǎncè
斬	zhǎn
斬釘截鐵	zhǎndīngjiétiĕ
嶄露頭角	zhǎnlùtóujiǎo
*佔地	zhàndì
站立	zhànlì
湛藍	zhànlán
綻放	zhànfàng
戰車	zhànchē
戰火	zhànhuŏ
戰果	zhànguŏ
戰機	zhànjī
戰績	zhànjì
戰艦	zhànjiàn
戰亂	zhànluàn
戰事	zhànshì
張開	zhāngkāi
張力	zhānglì
張貼	zhāngtiē
張望	zhāngwàng
張揚	zhāngyáng
章節	zhāngjié
樟木	zhāngmù
蟑螂	zhāngláng
長輩	zhǎngbèi
*長大	zhǎngdà
*長者	zhǎngzhĕ
掌舵	zhǎngduò
掌故	zhǎnggù
掌櫃	zhǎngguì
掌門人	zhǎngménrén
*掌聲	zhǎngshēng
掌心	zhǎngxīn
杖	zhàng
障	zhàng
賬簿	zhàngbù
賬單	zhàngdān
賬號	zhànghào
*賬戶	zhànghù
賬款	zhàngkuǎn
*賬目	zhàngmù
賬務	zhàngwù
*招標	zhāobiāo
*招股	zhāogŭ
招徠	zhāolái
招攬	zhāolǎn
招募	zhāomù
*招牌	zhāo·pai
*招聘	zhāopìn
招惹	zhāo·rĕ
招商	zhāoshāng
招數	zhāoshù
*招致	zhāozhì
招租	zhāozū
着數	zhāoshù
朝思暮想	zhāosīmùxiǎng
朝霞	zhāoxiá
朝陽	zhāoyáng
著迷	zháomí
爪	zhǎo
*找尋	zhǎoxún
召	zhào
召喚	zhàohuàn
兆	zhào
兆頭	zhào·tou
罩	zhào
肇事	zhàoshì
遮蔽	zhēbì
遮擋	zhēdǎng
遮蓋	zhēgài
遮掩	zhēyǎn
折返	zhéfǎn
折服	zhéfú
折舊	zhéjiù
*折扣	zhékòu
折衷	zhézhōng
折子戲	zhé·zixì
哲	zhé
哲理	zhélǐ
哲學家	zhéxuéjiā
摺疊	zhédié
摺疊傘	zhédiésǎn
轍	zhé
蔗	zhè
蔗糖	zhètáng
珍	zhēn
*珍寶	zhēnbǎo
*珍藏	zhēncáng
珍品	zhēnpǐn
珍視	zhēnshì
*珍惜	zhēnxī
珍稀	zhēnxī
真諦	zhēndì
真夠受	zhēngòushòu
真跡	zhēnjì
真菌	zhēnjūn
真切	zhēnqiè
*真情	zhēnqíng
真確	zhēnquè
真偽	zhēnwĕi
*真相	zhēnxiàng
真心	zhēnxīn
真知灼見	zhēnzhīzhuójiàn
真摯	zhēnzhì
砧	zhēn
*砧板	zhēnbǎn
針鋒相對	zhēnfēngxiāngduì
針筒	zhēntŏng
針織	zhēnzhī
貞	zhēn
偵測	zhēncè
偵緝	zhēnjī
偵破	zhēnpò
*偵探	zhēntàn
偵訊	zhēnxùn
斟	zhēn
斟酌	zhēnzhuó
*甄選	zhēnxuǎn
榛子	zhēn·zi
枕	zhĕn
診	zhĕn
診療	zhĕnliáo
*診所	zhĕnsuŏ
診治	zhĕnzhì
縝密	zhĕnmì
震蕩	zhèndàng
震耳欲聾	zhèn'ĕryùlóng
震撼	zhènhàn
震懾	zhènshè
陣腳	zhènjiǎo
*陣容	zhènróng
陣式	zhènshì
征戰	zhēngzhàn
爭辯	zhēngbiàn
爭持	zhēngchí
爭鬥	zhēngdòu
爭分奪秒	zhēngfēnduómiǎo
爭光	zhēngguāng
爭勝	zhēngshèng
爭先恐後	zhēngxiānkŏnghòu
*爭議	zhēngyì
爭執	zhēngzhí
蒸餾	zhēngliú
蒸籠	zhēnglóng
蒸蒸日上	zhēngzhēngrìshàng
徵集	zhēngjí
徵稅	zhēngshuì
*徵詢	zhēngxún
徵用	zhēngyòng
徵兆	zhēngzhào
*拯救	zhĕngjiù
*整合	zhĕnghé
整潔	zhěngjié
整套	zhĕngtào
*整天	zhĕngtiān
正版	zhèngbǎn
正方	zhèngfāng
正門	zhèngmén
正派	zhèngpài
正視	zhèngshì
正統	zhèngtŏng
正午	zhèngwŭ
正選	zhèngxuǎn
正直	zhèngzhí
正中	zhèngzhōng
*正宗	zhèngzōng
政改	zhènggǎi
政績	zhèngjì
政見	zhèngjiàn
政界	zhèngjiè
*政局	zhèngjú
政客	zhèngkè
*政務	zhèngwù
*政務司	zhèngwùsī
政要	zhèngyào
政制	zhèngzhì
掙脫	zhèngtuō
諍友	zhèngyŏu
*證件	zhèngjiàn
*證券	zhèngquàn
*證人	zhèngrén
證物	zhèngwù
支行	zhīháng
支架	zhījià
支流	zhīliú
支票	zhīpiào
支取	zhīqŭ
支吾	zhī·wú
*支線	zhīxiàn
*支柱	zhīzhù
枝節	zhījié
*肢體	zhītǐ
汁液	zhīyè
*芝麻	zhī·ma
芝麻醬	zhī·majiàng
知己	zhījǐ
知己知彼	zhījǐzhībǐ
*知名	zhīmíng
知名度	zhīmíngdù
知情	zhīqíng
*知悉	zhīxī
知心	zhīxīn
知音	zhīyīn
脂	zhī
*直達	zhídá
直截了當	zhíjiéliǎodàng
直溜溜	zhíliūliū
直面	zhímiàn
直射	zhíshè
直升	zhíshēng
直升機	zhíshēngjī
直屬	zhíshŭ
直通	zhítōng
直通車	zhítōngchē
直言不諱	zhíyánbùhuì
直指	zhízhǐ
值錢	zhíqián
植樹	zhíshù
植物人	zhíwùrén
植物油	zhíwùyóu
植株	zhízhū
姪	zhí
姪兒	zhí'ér
姪女	zhínǚ
執	zhí
執筆	zhíbǐ
執導	zhídǎo
執教	zhíjiào
*執業	zhíyè
執掌	zhízhǎng
*執照	zhízhào
*執著	zhízhuó
職場	zhíchǎng
職級	zhíjí
職守	zhíshŏu
*職位	zhíwèi
職業病	zhíyèbìng
止痛	zhǐtòng
止痛藥	zhǐtòngyào
址	zhǐ
趾	zhǐ
旨	zhǐ
指斥	zhǐchì
指揮家	zhǐhuījiā
指甲	zhǐ·jia(zhī·jia)
指尖	zhǐjiān
指教	zhǐjiào
*指控	zhǐkòng
*指南	zhǐnán
指日可待	zhǐrìkĕdài
指紋	zhǐwén
*指引	zhǐyǐn
指摘	zhǐzhāi
指正	zhǐzhèng
指證	zhǐzhèng
咫尺	zhǐchǐ
紙筆	zhǐbǐ
*紙幣	zhǐbì
紙袋	zhǐdài
紙巾	zhǐjīn
紙牌	zhǐpái
紙條	zhǐtiáo
紙箱	zhǐxiāng
紙屑	zhǐxiè
紙業	zhǐyè
*紙張	zhǐzhāng
紙醉金迷	zhǐzuìjīnmí
至高無上	zhìgāowúshàng
至親	zhìqīn
至尊	zhìzūn
*致辭	zhìcí
*致電	zhìdiàn
致函	zhìhán
*致敬	zhìjìng
*致力	zhìlì
*致命	zhìmìng
致命傷	zhìmìngshāng
致謝	zhìxiè
致意	zhìyì
窒礙	zhì'ài
窒息	zhìxī
志氣	zhì·qì
志同道合	zhìtóngdàohé
志向	zhìxiàng
*志願	zhìyuàn
痣	zhì
*制服	zhìfú
制衡	zhìhéng
製備	zhìbèi
炙	zhì
炙熱	zhìrè
炙手可熱	zhìshŏukĕrè
智囊	zhìnáng
智障	zhìzhàng
稚	zhì
稚氣	zhìqì
*置身	zhìshēn
置身事外	zhìshēnshìwài
滯後	zhìhòu
滯留	zhìliú
幟	zhì
摯愛	zhì'ài
摯友	zhìyŏu
質感	zhìgǎn
質問	zhìwèn
質詢	zhìxún
*質疑	zhìyí
擲	zhì
擲地有聲	zhìdìyŏushēng
中產	zhōngchǎn
*中場	zhōngchǎng
中程	zhōngchéng
中鋒	zhōngfēng
中堅	zhōngjiān
中將	zhōngjiàng
中看	zhōngkàn
*中立	zhōnglì
中流	hōngliú
中流砥柱	zhōngliúdǐzhù
*中秋節	Zhōngqiūjié
*中式	zhōngshì
中聽	zhōngtīng
*中途	zhōngtú
中西	zhōngxī
*中藥	zhōngyào
中庸	zhōngyōng
中用	zhōngyòng
*中止	zhōngzhǐ
中指	zhōngzhǐ
中裝	zhōngzhuāng
忠	zhōng
忠告	zhōnggào
忠烈	zhōngliè
忠心	zhōngxīn
*衷心	zhōngxīn
衷情	zhōngqíng
終端	zhōngduān
終端機	zhōngduānjī
終極	zhōngjí
*終結	zhōngjié
終日	zhōngrì
終審權	zhōngshĕnquán
*終止	zhōngzhǐ
鍾愛	zhōng'ài
鍾情	zhōngqíng
*鐘錶	zhōngbiǎo
*鐘樓	zhōnglóu
鐘聲	zhōngshēng
腫痛	zhŏngtòng
腫脹	zhŏngzhàng
*種籽	zhŏngzǐ
中標	zhòngbiāo
*中風	zhòngfēng
中獎	zhòngjiǎng
中肯	zhòngkĕn
中暑	zhòngshŭ
中選	zhòngxuǎn
仲	zhòng
*仲裁	zhòngcái
重本	zhòngbĕn
重病	zhòngbìng
重擔	zhòngdàn
重任	zhòngrèn
重頭戲	zhòngtóuxì
重用	zhòngyòng
重鎮	zhòngzhèn
重症	zhòngzhèng
眾矢之的	zhòngshǐzhīdì
眾所周知	zhòngsuŏzhōuzhī
眾望所歸	zhòngwàngsuŏguī
舟	zhōu
周會	zhōuhuì
*周全	zhōuquán
周詳	zhōuxiáng
周旋	zhōuxuán
周遊	zhōuyóu
週而復始	zhōu'érfùshǐ
週報	zhōubào
週刊	zhōukān
*週末	zhōumò
洲	zhōu
粥	zhōu
軸心	zhóuxīn
咒	zhòu
咒語	zhòuyŭ
晝	zhòu
皺眉	zhòuméi
驟	zhòu
驟然	zhòurán
驟雨	zhòuyŭ
*珠寶	zhūbǎo
誅	zhū
豬排	zhūpái
*豬肉	zhūròu
竹筒	zhútŏng
燭	zhú
燭光	zhúguāng
*主辦	zhŭbàn
*主場	zhŭchǎng
主唱	zhŭchàng
*主持人	zhŭchírén
主廚	zhŭchú
主婦	zhŭfù
主見	zhŭjiàn
*主講	zhŭjiǎng
主將	zhŭjiàng
*主角	zhŭjué
*主流	zhŭliú
主腦	zhŭnǎo
主帥	zhŭshuài
*主題曲	zhŭtíqŭ
*主演	zhŭyǎn
主宰	zhŭzǎi
主旨	zhŭzhǐ
屬意	zhŭyì
矚	zhŭ
*矚目	zhŭmù
*住戶	zhùhù
*住宿	zhùsù
*住所	zhùsuŏ
住址	zhùzhǐ
注定	zhùdìng
*注資	zhùzī
蛀	zhù
蛀牙	zhùyá
註腳	zhùjiǎo
駐兵	zhùbīng
駐軍	zhùjūn
駐守	zhùshŏu
駐足	zhùzú
佇立	zhùlì
貯	zhù
*助理	zhùlǐ
祝禱	zhùdǎo
*祝福	zhùfú
著稱	zhùchēng
爪	zhuǎ
*專案	zhuān'àn
*專長	zhuāncháng
專車	zhuānchē
專誠	zhuānchéng
*專訪	zhuānfǎng
專櫃	zhuānguì
*專輯	zhuānjí
*專科	zhuānkē
*專欄	zhuānlán
專利權	zhuānlìquán
*專賣	zhuānmài
*專人	zhuānrén
*專線	zhuānxiàn
*專項	zhuānxiàng
*專心	zhuānxīn
*專營	zhuānyíng
*專員	zhuānyuán
專責	zhuānzé
*專注	zhuānzhù
磚牆	zhuānqiáng
轉攻	zhuǎngōng
轉行	zhuǎnháng
轉換器	zhuǎnhuànqì
轉機	zhuǎnjī
轉嫁	zhuǎnjià
轉角	zhuǎnjiǎo
*轉口	zhuǎnkŏu
轉捩點	zhuǎnlièdiǎn
*轉讓	zhuǎnràng
轉世	zhuǎnshì
轉手	zhuǎnshŏu
轉述	zhuǎnshù
轉投	zhuǎntóu
*轉型	zhuǎnxíng
轉眼	zhuǎnyǎn
轉運	zhuǎnyùn
轉載	zhuǎnzài
轉賬	zhuǎnzhàng
撰	zhuàn
撰述	zhuànshù
撰文	zhuànwén
*撰寫	zhuànxiĕ
饌	zhuàn
*賺錢	zhuànqián
*賺取	zhuànqŭ
妝	zhuāng
莊家	zhuāng·jia
莊園	zhuāngyuán
裝扮	zhuāngbàn
裝潢	zhuānghuáng
裝模作樣	zhuāngmúzuòyàng
*裝設	zhuāngshè
裝飾	zhuāngshì
裝束	zhuāngshù
*裝修	zhuāngxiū
裝運	zhuāngyùn
壯健	zhuàngjiàn
壯舉	zhuàngjŭ
壯闊	zhuàngkuò
*壯麗	zhuànglì
壯年	zhuàngnián
狀元	zhuàng·yuan
*狀書	zhuàngshū
撞車	zhuàngchē
撞擊	zhuàngjī
撞破	zhuàngpò
追捕	zhuībŭ
*追查	zhuīchá
追訪	zhuīfǎng
追擊	zhuījī
*追捧	zhuīpĕng
追思	zhuīsī
*追溯	zhuīsù
追隨	zhuīsuí
*追討	zhuītǎo
*追尋	zhuīxún
追憶	zhuīyì
追蹤	zhuīzōng
椎	zhuī
墜	zhuì
贅	zhuì
*准許	zhŭnxŭ
準時	zhŭnshí
拙	zhuō
捉迷藏	zhuōmícáng
捉弄	zhuōnòng
灼	zhuó
灼熱	zhuórè
灼痛	zhuótòng
酌	zhuó
酌量	zhuóliáng
*酌情	zhuóqíng
卓	zhuó
卓有成效	zhuóyŏuchéngxiào
茁壯	zhuózhuàng
啄	zhuó
著筆	zhuóbǐ
著地	zhuódì
著陸	zhuólù
著實	zhuóshí
著眼	zhuóyǎn
擢升	zhuóshēng
鐲子	zhuó·zi
姿	zī
*資歷	zīlì
*資深	zīshēn
*資訊	zīxùn
資質	zīzhì
滋	zī
滋補	zībŭ
滋擾	zīrǎo
滋潤	zīrùn
滋生	zīshēng
*滋味	zīwèi
滋養	zīyǎng
子夜	zǐyè
籽	zǐ
紫菜	zǐcài
紫荊花	zǐjīnghuā
紫砂	zǐshā
*紫外線	zǐwàixiàn
自卑	zìbēi
自備	zìbèi
自編	zìbiān
自殘	zìcán
自慚形穢	zìcánxínghuì
自嘲	zìcháo
自創	zìchuàng
自吹自擂	zìchuīzìléi
自大	zìdà
自得	zìdé
自負	zìfù
自給	zìjǐ
*自家	zìjiā
自薦	zìjiàn
自盡	zìjìn
自立	zìlì
*自律	zìlǜ
自欺欺人	zìqīqīrén
*自強	zìqiáng
自強不息	zìqiángbùxī
自然美	zìránmĕi
自食其力	zìshíqílì
*自私	zìsī
自問	zìwèn
自信心	zìxìnxīn
自修	zìxiū
自選	zìxuǎn
自言自語	zìyánzìyŭ
自以為是	zìyǐwéishì
自圓其說	zìyuánqíshuō
自怨自艾	zìyuànzìyì
自制	zìzhì
*自助	zìzhù
自助餐	zìzhùcān
自傳	zìzhuàn
自足	zìzú
自尊	zìzūn
字詞	zìcí
字彙	zìhuì
字跡	zìjì
字幕	zìmù
字數	zìshù
字體	zìtǐ
字條	zìtiáo
字帖兒	zìtiĕr
字帖	zìtiè
字形	zìxíng
字眼	zìyǎn
字樣	zìyàng
字音	zìyīn
字正腔圓	zìzhèngqiāngyuán
漬	zì
*宗祠	zōngcí
宗師	zōngshī
宗族	zōngzú
綜觀	zōngguān
*綜合症	zōnghézhèng
綜藝	zōngyì
蹤	zōng
蹤影	zōngyǐng
*總裁	zŏngcái
*總督	zŏngdū
*總監	zŏngjiān
總閘	zŏngzhá
縱橫	zònghéng
縱橫交錯	zònghéngjiāocuò
縱火	zònghuŏ
縱情	zòngqíng
縱然	zòngrán
縱容	zòngróng
*縱使	zòngshǐ
縱向	zòngxiàng
走動	zŏudòng
*走路	zŏulù
走俏	zŏuqiào
*走勢	zŏushì
*走私	zŏusī
走樣	zŏuyàng
走運	zŏuyùn
奏鳴曲	zòumíngqŭ
奏效	zòuxiào
奏折	zòuzhé
*租戶	zūhù
租借	zūjiè
*租金	zūjīn
*租客	zūkè
*租賃	zūlìn
*租用	zūyòng
*租約	zūyuē
足不出戶	zúbùchūhù
足跡	zújì
足球場	zúqiúchǎng
足下	zúxià
足印	zúyìn
足智多謀	zúzhìduōmóu
卒	zú
族譜	zúpŭ
族人	zúrén
阻隔	zŭgé
阻塞	zŭsè
阻滯	zŭzhì
祖墳	zŭfén
祖籍	zŭjí
*組別	zŭbié
*組成	zŭchéng
組建	zŭjiàn
組員	zŭyuán
詛咒	zŭzhòu
鑽探	zuāntàn
*鑽石	zuànshí
嘴饞	zuǐchán
嘴角	zuǐjiǎo
嘴臉	zuǐliǎn
*罪案	zuì'àn
*罪名	zuìmíng
罪孽	zuìniè
罪人	zuìrén
罪證	zuìzhèng
醉人	zuìrén
醉生夢死	zuìshēngmèngsǐ
醉心	zuìxīn
尊崇	zūnchóng
*尊貴	zūnguì
尊師重道	zūnshīzhòngdào
遵	zūn
*遵從	zūncóng
遵行	zūnxíng
樽	zūn
*昨晚	zuówǎn
昨夜	zuóyè
佐	zuŏ
佐酒	zuŏjiŭ
佐料	zuŏliào
作弊	zuòbì
*作客	zuòkè
作孽	zuòniè
*作曲	zuòqŭ
*作曲家	zuòqŭjiā
作勢	zuòshì
作息	zuòxī
作賊心虛	zuòzéixīnxū
*作證	zuòzhèng
*坐落	zuòluò
坐享其成	zuòxiǎngqíchéng
坐椅	zuòyǐ
坐鎮	zuòzhèn
座談	zuòtán
座談會	zuòtánhuì
座無虛席	zuòwúxūxí
座椅	zuòyǐ
作證	zuòzhèng
做媒	zuòméi
*做人	zuòrén
做生意	zuòshēng·yi
*做事	zuòshì
做作	zuò·zuo
